About|說明|说明	中文称呼（Chinese_Relationship）\n数据大小：5千，称呼词根；18万，中文称呼。语料来源：多个人名词典汇总。数据清洗：已清洗，但仍存有大量badcase。\n\nA word list of Chinese relationship terms. Note there may be several errors remaining.\n\nSource: By Wainshine, 2020.12.13 - https://github.com/wainshine/Chinese-Names-Corpus
Licence|License|授權條款|执照|授权条款	Apache License\n   Version 2.0, January 2004\nhttp://www.apache.org/licenses/\n\n   TERMS AND CONDITIONS FOR USE, REPRODUCTION, AND DISTRIBUTION\n\n   1. Definitions.\n\n"License" shall mean the terms and conditions for use, reproduction,\nand distribution as defined by Sections 1 through 9 of this document.\n\n"Licensor" shall mean the copyright owner or entity authorized by\nthe copyright owner that is granting the License.\n\n"Legal Entity" shall mean the union of the acting entity and all\nother entities that control, are controlled by, or are under common\ncontrol with that entity. For the purposes of this definition,\n"control" means (i) the power, direct or indirect, to cause the\ndirection or management of such entity, whether by contract or\notherwise, or (ii) ownership of fifty percent (50%) or more of the\noutstanding shares, or (iii) beneficial ownership of such entity.\n\n"You" (or "Your") shall mean an individual or Legal Entity\nexercising permissions granted by this License.\n\n"Source" form shall mean the preferred form for making modifications,\nincluding but not limited to software source code, documentation\nsource, and configuration files.\n\n"Object" form shall mean any form resulting from mechanical\ntransformation or translation of a Source form, including but\nnot limited to compiled object code, generated documentation,\nand conversions to other media types.\n\n"Work" shall mean the work of authorship, whether in Source or\nObject form, made available under the License, as indicated by a\ncopyright notice that is included in or attached to the work\n(an example is provided in the Appendix below).\n\n"Derivative Works" shall mean any work, whether in Source or Object\nform, that is based on (or derived from) the Work and for which the\neditorial revisions, annotations, elaborations, or other modifications\nrepresent, as a whole, an original work of authorship. For the purposes\nof this License, Derivative Works shall not include works that remain\nseparable from, or merely link (or bind by name) to the interfaces of,\nthe Work and Derivative Works thereof.\n\n"Contribution" shall mean any work of authorship, including\nthe original version of the Work and any modifications or additions\nto that Work or Derivative Works thereof, that is intentionally\nsubmitted to Licensor for inclusion in the Work by the copyright owner\nor by an individual or Legal Entity authorized to submit on behalf of\nthe copyright owner. For the purposes of this definition, "submitted"\nmeans any form of electronic, verbal, or written communication sent\nto the Licensor or its representatives, including but not limited to\ncommunication on electronic mailing lists, source code control systems,\nand issue tracking systems that are managed by, or on behalf of, the\nLicensor for the purpose of discussing and improving the Work, but\nexcluding communication that is conspicuously marked or otherwise\ndesignated in writing by the copyright owner as "Not a Contribution."\n\n"Contributor" shall mean Licensor and any individual or Legal Entity\non behalf of whom a Contribution has been received by Licensor and\nsubsequently incorporated within the Work.\n\n   2. Grant of Copyright License. Subject to the terms and conditions of\nthis License, each Contributor hereby grants to You a perpetual,\nworldwide, non-exclusive, no-charge, royalty-free, irrevocable\ncopyright license to reproduce, prepare Derivative Works of,\npublicly display, publicly perform, sublicense, and distribute the\nWork and such Derivative Works in Source or Object form.\n\n   3. Grant of Patent License. Subject to the terms and conditions of\nthis License, each Contributor hereby grants to You a perpetual,\nworldwide, non-exclusive, no-charge, royalty-free, irrevocable\n(except as stated in this section) patent license to make, have made,\nuse, offer to sell, sell, import, and otherwise transfer the Work,\nwhere such license applies only to those patent claims licensable\nby such Contributor that are necessarily infringed by their\nContribution(s) alone or by combination of their Contribution(s)\nwith the Work to which such Contribution(s) was submitted. If You\ninstitute patent litigation against any entity (including a\ncross-claim or counterclaim in a lawsuit) alleging that the Work\nor a Contribution incorporated within the Work constitutes direct\nor contributory patent infringement, then any patent licenses\ngranted to You under this License for that Work shall terminate\nas of the date such litigation is filed.\n\n   4. Redistribution. You may reproduce and distribute copies of the\nWork or Derivative Works thereof in any medium, with or without\nmodifications, and in Source or Object form, provided that You\nmeet the following conditions:\n\n(a) You must give any other recipients of the Work or\n    Derivative Works a copy of this License; and\n\n(b) You must cause any modified files to carry prominent notices\n    stating that You changed the files; and\n\n(c) You must retain, in the Source form of any Derivative Works\n    that You distribute, all copyright, patent, trademark, and\n    attribution notices from the Source form of the Work,\n    excluding those notices that do not pertain to any part of\n    the Derivative Works; and\n\n(d) If the Work includes a "NOTICE" text file as part of its\n    distribution, then any Derivative Works that You distribute must\n    include a readable copy of the attribution notices contained\n    within such NOTICE file, excluding those notices that do not\n    pertain to any part of the Derivative Works, in at least one\n    of the following places: within a NOTICE text file distributed\n    as part of the Derivative Works; within the Source form or\n    documentation, if provided along with the Derivative Works; or,\n    within a display generated by the Derivative Works, if and\n    wherever such third-party notices normally appear. The contents\n    of the NOTICE file are for informational purposes only and\n    do not modify the License. You may add Your own attribution\n    notices within Derivative Works that You distribute, alongside\n    or as an addendum to the NOTICE text from the Work, provided\n    that such additional attribution notices cannot be construed\n    as modifying the License.\n\nYou may add Your own copyright statement to Your modifications and\nmay provide additional or different license terms and conditions\nfor use, reproduction, or distribution of Your modifications, or\nfor any such Derivative Works as a whole, provided Your use,\nreproduction, and distribution of the Work otherwise complies with\nthe conditions stated in this License.\n\n   5. Submission of Contributions. Unless You explicitly state otherwise,\nany Contribution intentionally submitted for inclusion in the Work\nby You to the Licensor shall be under the terms and conditions of\nthis License, without any additional terms or conditions.\nNotwithstanding the above, nothing herein shall supersede or modify\nthe terms of any separate license agreement you may have executed\nwith Licensor regarding such Contributions.\n\n   6. Trademarks. This License does not grant permission to use the trade\nnames, trademarks, service marks, or product names of the Licensor,\nexcept as required for reasonable and customary use in describing the\norigin of the Work and reproducing the content of the NOTICE file.\n\n   7. Disclaimer of Warranty. Unless required by applicable law or\nagreed to in writing, Licensor provides the Work (and each\nContributor provides its Contributions) on an "AS IS" BASIS,\nWITHOUT WARRANTIES OR CONDITIONS OF ANY KIND, either express or\nimplied, including, without limitation, any warranties or conditions\nof TITLE, NON-INFRINGEMENT, MERCHANTABILITY, or FITNESS FOR A\nPARTICULAR PURPOSE. You are solely responsible for determining the\nappropriateness of using or redistributing the Work and assume any\nrisks associated with Your exercise of permissions under this License.\n\n   8. Limitation of Liability. In no event and under no legal theory,\nwhether in tort (including negligence), contract, or otherwise,\nunless required by applicable law (such as deliberate and grossly\nnegligent acts) or agreed to in writing, shall any Contributor be\nliable to You for damages, including any direct, indirect, special,\nincidental, or consequential damages of any character arising as a\nresult of this License or out of the use or inability to use the\nWork (including but not limited to damages for loss of goodwill,\nwork stoppage, computer failure or malfunction, or any and all\nother commercial damages or losses), even if such Contributor\nhas been advised of the possibility of such damages.\n\n   9. Accepting Warranty or Additional Liability. While redistributing\nthe Work or Derivative Works thereof, You may choose to offer,\nand charge a fee for, acceptance of support, warranty, indemnity,\nor other liability obligations and/or rights consistent with this\nLicense. However, in accepting such obligations, You may act only\non Your own behalf and on Your sole responsibility, not on behalf\nof any other Contributor, and only if You agree to indemnify,\ndefend, and hold each Contributor harmless for any liability\nincurred by, or claims asserted against, such Contributor by reason\nof your accepting any such warranty or additional liability.\n\n   END OF TERMS AND CONDITIONS\n\n   APPENDIX: How to apply the Apache License to your work.\n\nTo apply the Apache License to your work, attach the following\nboilerplate notice, with the fields enclosed by brackets "{}"\nreplaced with your own identifying information. (Don't include\nthe brackets!)  The text should be enclosed in the appropriate\ncomment syntax for the file format. We also recommend that a\nfile or class name and description of purpose be included on the\nsame "printed page" as the copyright notice for easier\nidentification within third-party archives.\n\n   Copyright {yyyy} {name of copyright owner}\n\n   Licensed under the Apache License, Version 2.0 (the "License");\n   you may not use this file except in compliance with the License.\n   You may obtain a copy of the License at\n\n http://www.apache.org/licenses/LICENSE-2.0\n\n   Unless required by applicable law or agreed to in writing, software\n   distributed under the License is distributed on an "AS IS" BASIS,\n   WITHOUT WARRANTIES OR CONDITIONS OF ANY KIND, either express or implied.\n   See the License for the specific language governing permissions and\n   limitations under the License.\n
哥	哥
儿	儿
老师	老师
姐	姐
总	总
仔	仔
爷	爷
少	少
哥哥	哥哥
妹	妹
先生	先生
宝宝	宝宝
弟	弟
头	头
叔	叔
老大	老大
娃	娃
毛	毛
兄	兄
姐姐	姐姐
老板	老板
男	男
小姐	小姐
妈	妈
少爷	少爷
老	老
氏	氏
同学	同学
妹妹	妹妹
女	女
大爷	大爷
妞	妞
崽	崽
嫂	嫂
家	家
经理	经理
宝贝	宝贝
大哥	大哥
帝	帝
公子	公子
公	公
小妹	小妹
格格	格格
伯	伯
婆	婆
胖子	胖子
师傅	师傅
主任	主任
夫人	夫人
叔叔	叔叔
妈妈	妈妈
小小	小小
丫	丫
导	导
太	太
毛毛	毛毛
娃子	娃子
爹	爹
大侠	大侠
佬	佬
爷爷	爷爷
皇	皇
娃娃	娃娃
丫头	丫头
大姐	大姐
老二	老二
咪	咪
爸	爸
弟弟	弟弟
美女	美女
老婆	老婆
某	某
姨	姨
某人	某人
小子	小子
女士	女士
书记	书记
班长	班长
娃儿	娃儿
小弟	小弟
爸爸	爸爸
妹儿	妹儿
国民	国民
娘	娘
妞妞	妞妞
妹子	妹子
教官	教官
大叔	大叔
小白	小白
帅哥	帅哥
队	队
太太	太太
老爷	老爷
老三	老三
王子	王子
咪咪	咪咪
校长	校长
丫丫	丫丫
孩	孩
工	工
局	局
先锋	先锋
将军	将军
博士	博士
大少	大少
阿姨	阿姨
二哥	二哥
嗲	嗲
公主	公主
医生	医生
姑娘	姑娘
某某	某某
老头	老头
主席	主席
胖胖	胖胖
二娃	二娃
教练	教练
大帅	大帅
乖乖	乖乖
囝	囝
姓	姓
美人	美人
大宝	大宝
仔仔	仔仔
老公	老公
大头	大头
会计	会计
囡囡	囡囡
少帅	少帅
十三	十三
部长	部长
三少	三少
媳妇	媳妇
太郎	太郎
大人	大人
师兄	师兄
疯子	疯子
军民	军民
大妈	大妈
小生	小生
律师	律师
之子	之子
天使	天使
妮儿	妮儿
哥仔	哥仔
奶	奶
子哥	子哥
神	神
胖	胖
鱼儿	鱼儿
小妖	小妖
副	副
小三	小三
二爷	二爷
队长	队长
大师	大师
三妹	三妹
小七	小七
十一	十一
公公	公公
教授	教授
小二	小二
老四	老四
老五	老五
百万	百万
大仙	大仙
大夫	大夫
英雄	英雄
小仙	小仙
司令	司令
姐夫	姐夫
包子	包子
七七	七七
婆娘	婆娘
婆婆	婆婆
部	部
二少	二少
秘书	秘书
奶奶	奶奶
狗狗	狗狗
女人	女人
贵妃	贵妃
无名	无名
行者	行者
大大	大大
鬼	鬼
妹几	妹几
小四	小四
三三	三三
二妹	二妹
院长	院长
半仙	半仙
君子	君子
小号	小号
伯伯	伯伯
总裁	总裁
政委	政委
科长	科长
一男	一男
女子	女子
太子	太子
伢子	伢子
迷	迷
同志	同志
所	所
大兵	大兵
笨笨	笨笨
肥	肥
处	处
哥儿	哥儿
长老	长老
王爷	王爷
主管	主管
猫儿	猫儿
十二	十二
保安	保安
三哥	三哥
贵宾	贵宾
小乖	小乖
鸭子	鸭子
牙子	牙子
秀才	秀才
表哥	表哥
局长	局长
学生	学生
小女	小女
全民	全民
长久	长久
小五	小五
天王	天王
者	者
子	子
夫子	夫子
小六	小六
掌柜	掌柜
元帅	元帅
少侠	少侠
仙子	仙子
嘉宾	嘉宾
伟哥	伟哥
婶	婶
嫂子	嫂子
老表	老表
士兵	士兵
爵爷	爵爷
老六	老六
小孩	小孩
三爷	三爷
帮主	帮主
大王	大王
三儿	三儿
贝勒	贝勒
疯	疯
四妹	四妹
崽崽	崽崽
山人	山人
员外	员外
和尚	和尚
仙女	仙女
小狗	小狗
二姐	二姐
总监	总监
九妹	九妹
水军	水军
十八	十八
兄弟	兄弟
六一	六一
家人	家人
朵儿	朵儿
师姐	师姐
水兵	水兵
五一	五一
一二	一二
瓜	瓜
丽姐	丽姐
皇后	皇后
六妹	六妹
朋友	朋友
总管	总管
春节	春节
十四	十四
助理	助理
神仙	神仙
世家	世家
龙哥	龙哥
天子	天子
大虾	大虾
大娘	大娘
妞儿	妞儿
十七	十七
男人	男人
群主	群主
明哥	明哥
阿哥	阿哥
痞子	痞子
小邪	小邪
男男	男男
董事	董事
千金	千金
十六	十六
副总	副总
十五	十五
老弟	老弟
大妹	大妹
万元	万元
儿子	儿子
耗子	耗子
老七	老七
小哥	小哥
母	母
中一	中一
徒	徒
居士	居士
会长	会长
小一	小一
五妹	五妹
七妹	七妹
六六	六六
厂长	厂长
爹爹	爹爹
蛋儿	蛋儿
领导	领导
矮子	矮子
九九	九九
仔哥	仔哥
贼	贼
娘娘	娘娘
大佬	大佬
林哥	林哥
团长	团长
亲王	亲王
爷们	爷们
二三	二三
小九	小九
肥肥	肥肥
妹仔	妹仔
道人	道人
四爷	四爷
三女	三女
十九	十九
委员	委员
八一	八一
小将	小将
学士	学士
总理	总理
表姐	表姐
华哥	华哥
小鬼	小鬼
奇才	奇才
大嫂	大嫂
嗲嗲	嗲嗲
贱人	贱人
皇帝	皇帝
骑士	骑士
嬷嬷	嬷嬷
村长	村长
少年	少年
玲姐	玲姐
军哥	军哥
所长	所长
堂主	堂主
二小	二小
头儿	头儿
剑客	剑客
二二	二二
狐狸	狐狸
姑姑	姑姑
大婶	大婶
孩儿	孩儿
小儿	小儿
老太	老太
丞相	丞相
处长	处长
流氓	流氓
中堂	中堂
花子	花子
婆子	婆子
妈咪	妈咪
大嘴	大嘴
老总	老总
相公	相公
老八	老八
老幺	老幺
太后	太后
地主	地主
妖精	妖精
战士	战士
女孩	女孩
儿哥	儿哥
强哥	强哥
狗儿	狗儿
三二	三二
千万	千万
燕姐	燕姐
小爷	小爷
梅姐	梅姐
二一	二一
三四	三四
管家	管家
连长	连长
丸子	丸子
弟兄	弟兄
三九	三九
三姐	三姐
四九	四九
排长	排长
杰哥	杰哥
平哥	平哥
中人	中人
警官	警官
文哥	文哥
人	人
站长	站长
涛哥	涛哥
司机	司机
痞	痞
园长	园长
医师	医师
小伙	小伙
白痴	白痴
少尉	少尉
真人	真人
三一	三一
财神	财神
蝶儿	蝶儿
组长	组长
三十	三十
老班	老班
国公	国公
三八	三八
东哥	东哥
大汉	大汉
儿妈	儿妈
超哥	超哥
丫子	丫子
父	父
大米	大米
少将	少将
法师	法师
爱女	爱女
二十	二十
战友	战友
生哥	生哥
老汉	老汉
二四	二四
八妹	八妹
女女	女女
辉哥	辉哥
道士	道士
一三	一三
舅舅	舅舅
四四	四四
三五	三五
儿姐	儿姐
萍姐	萍姐
飞哥	飞哥
他哥	他哥
四哥	四哥
太保	太保
娘子	娘子
悟空	悟空
七一	七一
青年	青年
九六	九六
长女	长女
学姐	学姐
一人	一人
五四	五四
郡主	郡主
布衣	布衣
九一	九一
勇哥	勇哥
老爹	老爹
二狗	二狗
傻子	傻子
笨蛋	笨蛋
霸王	霸王
哥子	哥子
娜姐	娜姐
宝妈	宝妈
八八	八八
鬼子	鬼子
五六	五六
小八	小八
参谋	参谋
总统	总统
二五	二五
九七	九七
四女	四女
姥姥	姥姥
一哥	一哥
一族	一族
男孩	男孩
呀子	呀子
三七	三七
狗蛋	狗蛋
孩子	孩子
四少	四少
宇哥	宇哥
师父	师父
神父	神父
二女	二女
酷儿	酷儿
霞姐	霞姐
大尉	大尉
药师	药师
点儿	点儿
波哥	波哥
大伯	大伯
老哥	老哥
公民	公民
五九	五九
护士	护士
常委	常委
女王	女王
长年	长年
峰哥	峰哥
六七	六七
鹏哥	鹏哥
六九	六九
满哥	满哥
至尊	至尊
八七	八七
六五	六五
军师	军师
三六	三六
大臣	大臣
市长	市长
王八	王八
崽子	崽子
人儿	人儿
会员	会员
四一	四一
土匪	土匪
教主	教主
五爷	五爷
痴	痴
拐子	拐子
侠客	侠客
女儿	女儿
妹崽	妹崽
店长	店长
行长	行长
编辑	编辑
二六	二六
四五	四五
七八	七八
二九	二九
五五	五五
五三	五三
大亨	大亨
老鬼	老鬼
少校	少校
中尉	中尉
四六	四六
情人	情人
镇长	镇长
他爹	他爹
表弟	表弟
一妹	一妹
乡长	乡长
庄主	庄主
六二	六二
长孙	长孙
妹机	妹机
大厨	大厨
阳哥	阳哥
禅师	禅师
叫兽	叫兽
天师	天师
六十	六十
宠儿	宠儿
御史	御史
崽儿	崽儿
狮子	狮子
四七	四七
九五	九五
斌哥	斌哥
四三	四三
海哥	海哥
家将	家将
死人	死人
三弟	三弟
殿下	殿下
五十	五十
学员	学员
五七	五七
太爷	太爷
太尉	太尉
亮哥	亮哥
六三	六三
八十	八十
呆子	呆子
二七	二七
社长	社长
九八	九八
四二	四二
爱子	爱子
师爷	师爷
七九	七九
小丑	小丑
一五	一五
磊哥	磊哥
顾问	顾问
五八	五八
老子	老子
六八	六八
艳姐	艳姐
四十	四十
七十	七十
猫咪	猫咪
坏蛋	坏蛋
州人	州人
记者	记者
圣人	圣人
五二	五二
掌门	掌门
的哥	的哥
二八	二八
丹姐	丹姐
九四	九四
一十	一十
表妹	表妹
农民	农民
家长	家长
干事	干事
指挥	指挥
师弟	师弟
师妹	师妹
娟姐	娟姐
八五	八五
状元	状元
游侠	游侠
妹姐	妹姐
侍郎	侍郎
七六	七六
七五	七五
纪委	纪委
一七	一七
导员	导员
婷姐	婷姐
九三	九三
县委	县委
护法	护法
太祖	太祖
一四	一四
老兵	老兵
骑兵	骑兵
小人	小人
六女	六女
师长	师长
少女	少女
九儿	九儿
作家	作家
大将	大将
官兵	官兵
老妖	老妖
一六	一六
九十	九十
国王	国王
人王	人王
姊妹	姊妹
中年	中年
泪儿	泪儿
八九	八九
鸟人	鸟人
木匠	木匠
嫂嫂	嫂嫂
一九	一九
七四	七四
好人	好人
四八	四八
哥们	哥们
鸡婆	鸡婆
男子	男子
叔公	叔公
艺人	艺人
傻瓜	傻瓜
战神	战神
大弟	大弟
八六	八六
园丁	园丁
吖子	吖子
学妹	学妹
王氏	王氏
仙姑	仙姑
县长	县长
太守	太守
舞者	舞者
三子	三子
一少	一少
考生	考生
他爸	他爸
龙神	龙神
山哥	山哥
八三	八三
成哥	成哥
都督	都督
乡人	乡人
姐儿	姐儿
九二	九二
猫子	猫子
一女	一女
郎君	郎君
十妹	十妹
子妈	子妈
船长	船长
锋哥	锋哥
武士	武士
领班	领班
大公	大公
八二	八二
姑爷	姑爷
八哥	八哥
股长	股长
安人	安人
头头	头头
姨妈	姨妈
专家	专家
浩哥	浩哥
村人	村人
混混	混混
乞丐	乞丐
县人	县人
宝哥	宝哥
大爹	大爹
二嫂	二嫂
斗士	斗士
天哥	天哥
彬哥	彬哥
班头	班头
刚哥	刚哥
姐妹	姐妹
俊哥	俊哥
八四	八四
五子	五子
佳氏	佳氏
凯哥	凯哥
导演	导演
新人	新人
七三	七三
六子	六子
莉姐	莉姐
野人	野人
营长	营长
家伙	家伙
君姐	君姐
老爸	老爸
一八	一八
闲人	闲人
兵哥	兵哥
头仔	头仔
魔女	魔女
芬姐	芬姐
九女	九女
主人	主人
五女	五女
使者	使者
公爵	公爵
七二	七二
小姑	小姑
流民	流民
中将	中将
二叔	二叔
老怪	老怪
亲家	亲家
妖怪	妖怪
汉子	汉子
家丁	家丁
村民	村民
魔王	魔王
大老	大老
名家	名家
大家	大家
刀客	刀客
助教	助教
十十	十十
狂人	狂人
武警	武警
二傻	二傻
学子	学子
帝王	帝王
囝囝	囝囝
硕士	硕士
后勤	后勤
侠女	侠女
教头	教头
支书	支书
花姐	花姐
蛮子	蛮子
良哥	良哥
幼儿	幼儿
主儿	主儿
秃子	秃子
男儿	男儿
长官	长官
游人	游人
馆长	馆长
女郎	女郎
李氏	李氏
上帝	上帝
散人	散人
技师	技师
徒弟	徒弟
江哥	江哥
混蛋	混蛋
天女	天女
郡王	郡王
宁哥	宁哥
市委	市委
理事	理事
表嫂	表嫂
二弟	二弟
大校	大校
老老	老老
菩萨	菩萨
教员	教员
畜生	畜生
主子	主子
威哥	威哥
武哥	武哥
五弟	五弟
太师	太师
云哥	云哥
恋人	恋人
涵妈	涵妈
善人	善人
健哥	健哥
修女	修女
志哥	志哥
婊子	婊子
班副	班副
娘们	娘们
洋哥	洋哥
班主	班主
寡妇	寡妇
骗子	骗子
学者	学者
胖哥	胖哥
雨哥	雨哥
童鞋	童鞋
松哥	松哥
头人	头人
二老	二老
春哥	春哥
行客	行客
厅长	厅长
魔神	魔神
星哥	星哥
导师	导师
四姐	四姐
牛哥	牛哥
菜鸟	菜鸟
表叔	表叔
无赖	无赖
修士	修士
传人	传人
铁匠	铁匠
天官	天官
德哥	德哥
判官	判官
祖先	祖先
女神	女神
猴儿	猴儿
他妈	他妈
老生	老生
名人	名人
副董	副董
行人	行人
敏哥	敏哥
利哥	利哥
博哥	博哥
尊者	尊者
容姐	容姐
电工	电工
鑫哥	鑫哥
胜哥	胜哥
老小	老小
富翁	富翁
光哥	光哥
司徒	司徒
上将	上将
省长	省长
瘦子	瘦子
师生	师生
驸马	驸马
忍者	忍者
盟主	盟主
捕头	捕头
老道	老道
海盗	海盗
荣哥	荣哥
西人	西人
阎王	阎王
神风	神风
老伯	老伯
皇子	皇子
九哥	九哥
仔妈	仔妈
雷哥	雷哥
奶妈	奶妈
娇姐	娇姐
长子	长子
兴哥	兴哥
财务	财务
四子	四子
八子	八子
洁姐	洁姐
狼人	狼人
八仙	八仙
少儿	少儿
虎哥	虎哥
老妈	老妈
土人	土人
女生	女生
阳姐	阳姐
子女	子女
外婆	外婆
小工	小工
教师	教师
姓氏	姓氏
干部	干部
幼女	幼女
力哥	力哥
飞姐	飞姐
家姐	家姐
刘氏	刘氏
宫主	宫主
祥哥	祥哥
奇哥	奇哥
国哥	国哥
莲姐	莲姐
外人	外人
发哥	发哥
宇妈	宇妈
院士	院士
绅士	绅士
星座	星座
巨人	巨人
牛仔	牛仔
贩子	贩子
张氏	张氏
二奶	二奶
豪哥	豪哥
贵族	贵族
军官	军官
饭桶	饭桶
义哥	义哥
岛主	岛主
湖人	湖人
你妈	你妈
之哥	之哥
隐士	隐士
乐哥	乐哥
老者	老者
族人	族人
神童	神童
清哥	清哥
雄哥	雄哥
民哥	民哥
月神	月神
术士	术士
庆哥	庆哥
七女	七女
冰人	冰人
色鬼	色鬼
难民	难民
陈氏	陈氏
洋人	洋人
总工	总工
堂妹	堂妹
师哥	师哥
青姐	青姐
坏人	坏人
武者	武者
神医	神医
侍卫	侍卫
织女	织女
门人	门人
粉儿	粉儿
天蝎	天蝎
全家	全家
厨师	厨师
球星	球星
水哥	水哥
坤哥	坤哥
妮姐	妮姐
儿爷	儿爷
好汉	好汉
男生	男生
毛哥	毛哥
福哥	福哥
牛郎	牛郎
辉姐	辉姐
君哥	君哥
牧民	牧民
影人	影人
皇上	皇上
猎人	猎人
先人	先人
猪哥	猪哥
职员	职员
愚人	愚人
懒虫	懒虫
辣妹	辣妹
老娘	老娘
马人	马人
面人	面人
权哥	权哥
警察	警察
姥爷	姥爷
翻译	翻译
探长	探长
风哥	风哥
壮士	壮士
名流	名流
才哥	才哥
弟哥	弟哥
胖妞	胖妞
他姐	他姐
轩妈	轩妈
珠姐	珠姐
达哥	达哥
专员	专员
族长	族长
青哥	青哥
为氏	为氏
主编	主编
粉丝	粉丝
源哥	源哥
的姐	的姐
大使	大使
子爷	子爷
女皇	女皇
南哥	南哥
兽医	兽医
督导	督导
智者	智者
香客	香客
智哥	智哥
海客	海客
西哥	西哥
草包	草包
老人	老人
孙子	孙子
金者	金者
楠哥	楠哥
圣王	圣王
课长	课长
副队	副队
喜哥	喜哥
癞子	癞子
琪妈	琪妈
刺客	刺客
民警	民警
虹姐	虹姐
猪仔	猪仔
头妹	头妹
游者	游者
狼哥	狼哥
隐者	隐者
老鸨	老鸨
忠哥	忠哥
军人	军人
虎王	虎王
动员	动员
大姑	大姑
小偷	小偷
前辈	前辈
雅士	雅士
森哥	森哥
琪姐	琪姐
红人	红人
杂种	杂种
彪哥	彪哥
舵主	舵主
射手	射手
影者	影者
生人	生人
家属	家属
商人	商人
瑜姐	瑜姐
然妈	然妈
世人	世人
海神	海神
火人	火人
文妈	文妈
阁老	阁老
副班	副班
古哥	古哥
君王	君王
铭哥	铭哥
头哥	头哥
恶少	恶少
童年	童年
猛哥	猛哥
主角	主角
副官	副官
施主	施主
宅男	宅男
尼姑	尼姑
婴儿	婴儿
姑姐	姑姐
迷人	迷人
佳哥	佳哥
霸主	霸主
男哥	男哥
剑哥	剑哥
火神	火神
阿婆	阿婆
周氏	周氏
女友	女友
士官	士官
女星	女星
范儿	范儿
狮王	狮王
闺女	闺女
米哥	米哥
风神	风神
惊人	惊人
婶婶	婶婶
股东	股东
爷儿	爷儿
党员	党员
侦探	侦探
聪哥	聪哥
鬼王	鬼王
妹夫	妹夫
保姆	保姆
处男	处男
旅长	旅长
枪手	枪手
文秘	文秘
杰姐	杰姐
丑女	丑女
死神	死神
娃哥	娃哥
分子	分子
自家	自家
来者	来者
鞋子	鞋子
胜者	胜者
杨氏	杨氏
王者	王者
龙族	龙族
伢仔	伢仔
边人	边人
茹姐	茹姐
厨子	厨子
豪妈	豪妈
游客	游客
客人	客人
夜叉	夜叉
乐妈	乐妈
恩师	恩师
渔民	渔民
神王	神王
鸿哥	鸿哥
波姐	波姐
员工	员工
强人	强人
人妖	人妖
富哥	富哥
巫婆	巫婆
儿童	儿童
娣姐	娣姐
雯姐	雯姐
工人	工人
马哥	马哥
领队	领队
情郎	情郎
保镖	保镖
宰相	宰相
怡妈	怡妈
怡姐	怡姐
毛孩	毛孩
强盗	强盗
官儿	官儿
议员	议员
神人	神人
田氏	田氏
门子	门子
啊哥	啊哥
业人	业人
女婿	女婿
区长	区长
姨夫	姨夫
冥王	冥王
丫鬟	丫鬟
神者	神者
来哥	来哥
勇者	勇者
梦神	梦神
楼主	楼主
花人	花人
工头	工头
文盲	文盲
门客	门客
爱者	爱者
网管	网管
老贼	老贼
浩妈	浩妈
儿女	儿女
小贩	小贩
霖妈	霖妈
芝姐	芝姐
小叔	小叔
儿爸	儿爸
虎将	虎将
演员	演员
之者	之者
酷哥	酷哥
和人	和人
人哥	人哥
宾哥	宾哥
相好	相好
老外	老外
巴哥	巴哥
楠姐	楠姐
型男	型男
宫女	宫女
过客	过客
人者	人者
娥姐	娥姐
怪物	怪物
花痴	花痴
爱神	爱神
屋人	屋人
彤妈	彤妈
顽童	顽童
良人	良人
烦人	烦人
鸡哥	鸡哥
中哥	中哥
肥婆	肥婆
皮哥	皮哥
武神	武神
白羊	白羊
瘪三	瘪三
女巫	女巫
门神	门神
贱男	贱男
导游	导游
川哥	川哥
异人	异人
菲妈	菲妈
县令	县令
将领	将领
护卫	护卫
雨姐	雨姐
宁妈	宁妈
籽哥	籽哥
杰妈	杰妈
名将	名将
哲妈	哲妈
贵哥	贵哥
影帝	影帝
舅妈	舅妈
名师	名师
阳妈	阳妈
鱼仔	鱼仔
外公	外公
墨客	墨客
城哥	城哥
赵氏	赵氏
姑父	姑父
睿妈	睿妈
亚姐	亚姐
鱼哥	鱼哥
怪兽	怪兽
笑人	笑人
洋妈	洋妈
近人	近人
仪姐	仪姐
名优	名优
源妈	源妈
林氏	林氏
出纳	出纳
友哥	友哥
洛神	洛神
令友	令友
长人	长人
红娘	红娘
水手	水手
纯姐	纯姐
凡妈	凡妈
舅子	舅子
老兄	老兄
蛋哥	蛋哥
房东	房东
人家	人家
樵夫	樵夫
老友	老友
铭妈	铭妈
特氏	特氏
黄氏	黄氏
亲友	亲友
车人	车人
二氏	二氏
子爸	子爸
狼族	狼族
老乡	老乡
克氏	克氏
远哥	远哥
酋长	酋长
媚姐	媚姐
天者	天者
浪者	浪者
校正	校正
木哥	木哥
伴侣	伴侣
扬妈	扬妈
吴氏	吴氏
歌哥	歌哥
业者	业者
黑客	黑客
寻者	寻者
车子	车子
港人	港人
刀手	刀手
伦哥	伦哥
居者	居者
妞妈	妞妈
米人	米人
瑶妈	瑶妈
神女	神女
月哥	月哥
骚货	骚货
一姐	一姐
佛爷	佛爷
男友	男友
孙氏	孙氏
航妈	航妈
扬哥	扬哥
角儿	角儿
战将	战将
喜人	喜人
康哥	康哥
哑巴	哑巴
长哥	长哥
心哥	心哥
剑者	剑者
贤姐	贤姐
古人	古人
马氏	马氏
元老	元老
夜人	夜人
裁缝	裁缝
人狂	人狂
情者	情者
队员	队员
众人	众人
贤哥	贤哥
火王	火王
魔头	魔头
爪子	爪子
方丈	方丈
姑子	姑子
宸妈	宸妈
奇人	奇人
楠妈	楠妈
下人	下人
琪哥	琪哥
皇爷	皇爷
诚哥	诚哥
越妈	越妈
白领	白领
悦妈	悦妈
妮妈	妮妈
汉人	汉人
诺妈	诺妈
神灵	神灵
台人	台人
神哥	神哥
猫女	猫女
然哥	然哥
她妈	她妈
航哥	航哥
知者	知者
名氏	名氏
大腕	大腕
爹地	爹地
人族	人族
巫师	巫师
画家	画家
巴人	巴人
教父	教父
牙医	牙医
捕快	捕快
群哥	群哥
善者	善者
升哥	升哥
亿人	亿人
魔人	魔人
后卫	后卫
蒙哥	蒙哥
鑫妈	鑫妈
乖女	乖女
顺哥	顺哥
猫王	猫王
市人	市人
内人	内人
理哥	理哥
能哥	能哥
欣妈	欣妈
通人	通人
唐人	唐人
雯妈	雯妈
丑男	丑男
士哥	士哥
归人	归人
基哥	基哥
陛下	陛下
她哥	她哥
狗哥	狗哥
同事	同事
宅女	宅女
股神	股神
渣子	渣子
道哥	道哥
妍妈	妍妈
枪王	枪王
雅氏	雅氏
尼哥	尼哥
门徒	门徒
幺哥	幺哥
远人	远人
雨妈	雨妈
茶人	茶人
特务	特务
徐氏	徐氏
希妈	希妈
原人	原人
狐仙	狐仙
伙计	伙计
法人	法人
博妈	博妈
豆妈	豆妈
榜眼	榜眼
皓妈	皓妈
官府	官府
亲朋	亲朋
翔妈	翔妈
羊人	羊人
舍人	舍人
轩哥	轩哥
琦妈	琦妈
辰妈	辰妈
拾遗	拾遗
泥人	泥人
总督	总督
邪神	邪神
车族	车族
聋子	聋子
教徒	教徒
口人	口人
醉人	醉人
同桌	同桌
动人	动人
侄女	侄女
萱妈	萱妈
魂者	魂者
花哥	花哥
黑哥	黑哥
己人	己人
讲师	讲师
梁氏	梁氏
郑氏	郑氏
瑞妈	瑞妈
前人	前人
金氏	金氏
病人	病人
宝爸	宝爸
路哥	路哥
酒鬼	酒鬼
妖女	妖女
河哥	河哥
泽妈	泽妈
丈夫	丈夫
人丁	人丁
军警	军警
车夫	车夫
首人	首人
宾客	宾客
夜神	夜神
帮办	帮办
星爷	星爷
吉哥	吉哥
琳妈	琳妈
媒婆	媒婆
畅妈	畅妈
王哥	王哥
宇爸	宇爸
新娘	新娘
坑人	坑人
战者	战者
旅人	旅人
岭人	岭人
业主	业主
总编	总编
理人	理人
血人	血人
罗氏	罗氏
托儿	托儿
母子	母子
场人	场人
财哥	财哥
渔翁	渔翁
泪人	泪人
她姐	她姐
佬哥	佬哥
业哥	业哥
武人	武人
校友	校友
歌者	歌者
心妈	心妈
拉哥	拉哥
御医	御医
钱人	钱人
文氏	文氏
少妇	少妇
流人	流人
野哥	野哥
包哥	包哥
主公	主公
贵妇	贵妇
龙氏	龙氏
宝氏	宝氏
暴君	暴君
攀哥	攀哥
石匠	石匠
屠户	屠户
伙伴	伙伴
林妈	林妈
帆哥	帆哥
颖妈	颖妈
通哥	通哥
熙妈	熙妈
旗人	旗人
昕妈	昕妈
渡人	渡人
信者	信者
懒人	懒人
郎哥	郎哥
皮匠	皮匠
常人	常人
弃儿	弃儿
司长	司长
死鬼	死鬼
霖哥	霖哥
钓者	钓者
迪妈	迪妈
后人	后人
苏氏	苏氏
步者	步者
猫哥	猫哥
朱氏	朱氏
卢氏	卢氏
丁哥	丁哥
羽妈	羽妈
果妈	果妈
玩家	玩家
骏哥	骏哥
祺妈	祺妈
尖子	尖子
刀人	刀人
狼狗	狼狗
五哥	五哥
帝哥	帝哥
夫哥	夫哥
穷人	穷人
闲者	闲者
仪妈	仪妈
猴王	猴王
凯妈	凯妈
晴妈	晴妈
琪爸	琪爸
鬼神	鬼神
恒妈	恒妈
隆哥	隆哥
歌王	歌王
尔氏	尔氏
休哥	休哥
浪哥	浪哥
望者	望者
牙哥	牙哥
桥哥	桥哥
婷妈	婷妈
昆哥	昆哥
酒哥	酒哥
事人	事人
耕者	耕者
洲哥	洲哥
靓仔	靓仔
偶人	偶人
妇人	妇人
羽哥	羽哥
猴哥	猴哥
楼人	楼人
石者	石者
丹哥	丹哥
达妈	达妈
奶爸	奶爸
魔者	魔者
霸哥	霸哥
贰哥	贰哥
茜氏	茜氏
红姐	红姐
航者	航者
地王	地王
璇妈	璇妈
山者	山者
昌哥	昌哥
叁哥	叁哥
怡爸	怡爸
船人	船人
兰氏	兰氏
离人	离人
路姐	路姐
神婆	神婆
枫哥	枫哥
淇妈	淇妈
迪哥	迪哥
魔师	魔师
八姐	八姐
桐妈	桐妈
铭爸	铭爸
姑妈	姑妈
村仔	村仔
干妈	干妈
弟仔	弟仔
车王	车王
比哥	比哥
崽哥	崽哥
玉哥	玉哥
晨妈	晨妈
奇妈	奇妈
姓者	姓者
可妈	可妈
鹏妈	鹏妈
七哥	七哥
眼哥	眼哥
云氏	云氏
俗人	俗人
娃妈	娃妈
勒氏	勒氏
杰氏	杰氏
猎者	猎者
塔人	塔人
许氏	许氏
无人	无人
茗氏	茗氏
丰哥	丰哥
朗哥	朗哥
乐氏	乐氏
法者	法者
奎哥	奎哥
比仔	比仔
伯氏	伯氏
全哥	全哥
旭哥	旭哥
里哥	里哥
一妈	一妈
臣哥	臣哥
种人	种人
童哥	童哥
寨人	寨人
猫仔	猫仔
峰人	峰人
利氏	利氏
莹妈	莹妈
楷哥	楷哥
帅妈	帅妈
作者	作者
翔哥	翔哥
旺哥	旺哥
营哥	营哥
杨妈	杨妈
农人	农人
晨姐	晨姐
狐妖	狐妖
壮哥	壮哥
命者	命者
豪爸	豪爸
何人	何人
静者	静者
草哥	草哥
岛人	岛人
家哥	家哥
翔者	翔者
皮仔	皮仔
浪仔	浪仔
郭氏	郭氏
情哥	情哥
牙仔	牙仔
毅哥	毅哥
灵人	灵人
菲姐	菲姐
戈哥	戈哥
渔人	渔人
泉哥	泉哥
男姐	男姐
妹妈	妹妈
命人	命人
山氏	山氏
德氏	德氏
落人	落人
梁哥	梁哥
熙哥	熙哥
柱哥	柱哥
进哥	进哥
强者	强者
琦姐	琦姐
涵爸	涵爸
幺爸	幺爸
玥妈	玥妈
灯人	灯人
晓哥	晓哥
六哥	六哥
群者	群者
尼妈	尼妈
车男	车男
涛妈	涛妈
尔哥	尔哥
龙妈	龙妈
高氏	高氏
乐爸	乐爸
手哥	手哥
孔氏	孔氏
兔哥	兔哥
毅妈	毅妈
米妈	米妈
俊妈	俊妈
泰哥	泰哥
标哥	标哥
牧者	牧者
百氏	百氏
二妈	二妈
吕氏	吕氏
墨者	墨者
影姐	影姐
好妈	好妈
狼者	狼者
度人	度人
泽氏	泽氏
举哥	举哥
土哥	土哥
深人	深人
领人	领人
口哥	口哥
雷人	雷人
拓者	拓者
牛者	牛者
巢人	巢人
天氏	天氏
鲁氏	鲁氏
球王	球王
猪妈	猪妈
州哥	州哥
晖哥	晖哥
盛哥	盛哥
绿人	绿人
超妈	超妈
唐氏	唐氏
冲哥	冲哥
觉者	觉者
月氏	月氏
娴姐	娴姐
刀仔	刀仔
川妈	川妈
你爸	你爸
火哥	火哥
聪妈	聪妈
惠氏	惠氏
秦氏	秦氏
卓妈	卓妈
鹤人	鹤人
旋姐	旋姐
鹰哥	鹰哥
地哥	地哥
菜哥	菜哥
麻哥	麻哥
比妈	比妈
拉姐	拉姐
玉妈	玉妈
睿爸	睿爸
街人	街人
想者	想者
彩姐	彩姐
油人	油人
远妈	远妈
事者	事者
缘者	缘者
她爸	她爸
果哥	果哥
媛姐	媛姐
萌妈	萌妈
女仔	女仔
冰者	冰者
辉妈	辉妈
猪人	猪人
裕哥	裕哥
集人	集人
能人	能人
条哥	条哥
野氏	野氏
鲁哥	鲁哥
洁妈	洁妈
白哥	白哥
尔妈	尔妈
蓝人	蓝人
翰妈	翰妈
独人	独人
雅妈	雅妈
哲哥	哲哥
洪氏	洪氏
瑜妈	瑜妈
婷氏	婷氏
慧妈	慧妈
子姐	子姐
翼人	翼人
珠妈	珠妈
柳氏	柳氏
猿人	猿人
沟人	沟人
键哥	键哥
忧人	忧人
诚妈	诚妈
丹妈	丹妈
齐哥	齐哥
娃姐	娃姐
五姐	五姐
臣氏	臣氏
经人	经人
大爸	大爸
钊哥	钊哥
多哥	多哥
曦哥	曦哥
悠人	悠人
渔者	渔者
含妈	含妈
朝哥	朝哥
来妈	来妈
旗哥	旗哥
晨爸	晨爸
群人	群人
芸姐	芸姐
煜妈	煜妈
佳妈	佳妈
球者	球者
黑仔	黑仔
广哥	广哥
七姐	七姐
奕妈	奕妈
猪者	猪者
彦妈	彦妈
仁哥	仁哥
方氏	方氏
枝姐	枝姐
别人	别人
傻哥	傻哥
长者	长者
奥妈	奥妈
皮人	皮人
女者	女者
白氏	白氏
程妈	程妈
鸡仔	鸡仔
特哥	特哥
楠爸	楠爸
志者	志者
易妈	易妈
舒氏	舒氏
年哥	年哥
青妈	青妈
荇者	荇者
田者	田者
亲人	亲人
勋哥	勋哥
永哥	永哥
蛋妈	蛋妈
成妈	成妈
滩人	滩人
恒哥	恒哥
药人	药人
酒人	酒人
科哥	科哥
蛮人	蛮人
武氏	武氏
空人	空人
帆妈	帆妈
杨人	杨人
琴者	琴者
馨氏	馨氏
肥仔	肥仔
彤爸	彤爸
气哥	气哥
阳氏	阳氏
爽哥	爽哥
伦妈	伦妈
形人	形人
魂人	魂人
医人	医人
信哥	信哥
体人	体人
华妈	华妈
莱氏	莱氏
涯人	涯人
朋哥	朋哥
鬼哥	鬼哥
甲哥	甲哥
贤妈	贤妈
瑞哥	瑞哥
然爸	然爸
间人	间人
翼者	翼者
晨哥	晨哥
寒哥	寒哥
滨哥	滨哥
宜妈	宜妈
颜氏	颜氏
豹哥	豹哥
车神	车神
干哥	干哥
姆哥	姆哥
欣爸	欣爸
修哥	修哥
鸟哥	鸟哥
程氏	程氏
洞人	洞人
存者	存者
藕人	藕人
曦妈	曦妈
溪哥	溪哥
灵哥	灵哥
腿哥	腿哥
难人	难人
系人	系人
叼哥	叼哥
旭妈	旭妈
店人	店人
旦哥	旦哥
刀哥	刀哥
正哥	正哥
藏者	藏者
车手	车手
游哥	游哥
塘仔	塘仔
白人	白人
铃姐	铃姐
拉氏	拉氏
昊妈	昊妈
醒者	醒者
蒋氏	蒋氏
晗妈	晗妈
杨哥	杨哥
丘氏	丘氏
畅哥	畅哥
禾妈	禾妈
月者	月者
壹哥	壹哥
色哥	色哥
吉妈	吉妈
姜氏	姜氏
咪妈	咪妈
袁氏	袁氏
时者	时者
的妈	的妈
拽哥	拽哥
欣哥	欣哥
老姐	老姐
羽者	羽者
滢妈	滢妈
啸哥	啸哥
小妈	小妈
颜姐	颜姐
宅人	宅人
和哥	和哥
颜妈	颜妈
李哥	李哥
杜氏	杜氏
齐妈	齐妈
兰姐	兰姐
传者	传者
华仔	华仔
目者	目者
生者	生者
委哥	委哥
乡哥	乡哥
记哥	记哥
孟氏	孟氏
油哥	油哥
心仔	心仔
刀者	刀者
默者	默者
阿妈	阿妈
双哥	双哥
枚姐	枚姐
恩哥	恩哥
泽哥	泽哥
肥哥	肥哥
空者	空者
咬人	咬人
尧哥	尧哥
阳爸	阳爸
害人	害人
醒人	醒人
铁哥	铁哥
湖哥	湖哥
今者	今者
胡氏	胡氏
于氏	于氏
汪氏	汪氏
花者	花者
匠人	匠人
猪姐	猪姐
璇姐	璇姐
蕾妈	蕾妈
姚氏	姚氏
火者	火者
钦哥	钦哥
陵氏	陵氏
英姐	英姐
乐姐	乐姐
左氏	左氏
遥人	遥人
若人	若人
恋者	恋者
尕姐	尕姐
溪仔	溪仔
侠姐	侠姐
烨妈	烨妈
雪爸	雪爸
赫妈	赫妈
狗仔	狗仔
皇氏	皇氏
熊氏	熊氏
伍哥	伍哥
球哥	球哥
球人	球人
易者	易者
钓人	钓人
鼠哥	鼠哥
瑶姐	瑶姐
冉姐	冉姐
宋氏	宋氏
鹦哥	鹦哥
余者	余者
南姐	南姐
炮哥	炮哥
魏氏	魏氏
章氏	章氏
猫者	猫者
声人	声人
文爸	文爸
迷者	迷者
维哥	维哥
夏氏	夏氏
古氏	古氏
鱼者	鱼者
雪者	雪者
语妈	语妈
脚人	脚人
钰妈	钰妈
门哥	门哥
柏哥	柏哥
煌哥	煌哥
翔爸	翔爸
惠妈	惠妈
宏姐	宏姐
谢氏	谢氏
栋哥	栋哥
冰哥	冰哥
冯氏	冯氏
蛇人	蛇人
吃人	吃人
葬者	葬者
福妈	福妈
侯氏	侯氏
埠人	埠人
言妈	言妈
夜者	夜者
沙人	沙人
帆姐	帆姐
察氏	察氏
十哥	十哥
衫人	衫人
个哥	个哥
陆氏	陆氏
嘉妈	嘉妈
纸人	纸人
裁者	裁者
琦哥	琦哥
豆哥	豆哥
人氏	人氏
放哥	放哥
速者	速者
恋哥	恋哥
飞妈	飞妈
陆哥	陆哥
喆妈	喆妈
就哥	就哥
馨妈	馨妈
侠者	侠者
飘氏	飘氏
丁氏	丁氏
安氏	安氏
卿哥	卿哥
原哥	原哥
雨者	雨者
仔爸	仔爸
周人	周人
捷哥	捷哥
蟀哥	蟀哥
气人	气人
创者	创者
硕哥	硕哥
伊妈	伊妈
如人	如人
萌姐	萌姐
区人	区人
琼氏	琼氏
形者	形者
坚哥	坚哥
矮人	矮人
活人	活人
成氏	成氏
医者	医者
务人	务人
廖氏	廖氏
正妈	正妈
天爸	天爸
破人	破人
曹氏	曹氏
克哥	克哥
御者	御者
祖哥	祖哥
面哥	面哥
守者	守者
蟹哥	蟹哥
礼哥	礼哥
总哥	总哥
骨人	骨人
爸妈	爸妈
卡人	卡人
虎妈	虎妈
岗人	岗人
蛮哥	蛮哥
味人	味人
第哥	第哥
话人	话人
坊人	坊人
香妈	香妈
巍哥	巍哥
磊妈	磊妈
谦哥	谦哥
伞人	伞人
机哥	机哥
三妈	三妈
斗者	斗者
莲人	莲人
牛妈	牛妈
淑氏	淑氏
己者	己者
佛人	佛人
玺哥	玺哥
非哥	非哥
予妈	予妈
问者	问者
本哥	本哥
政妈	政妈
意哥	意哥
玛人	玛人
田妈	田妈
威妈	威妈
鬼人	鬼人
点哥	点哥
程姐	程姐
凡姐	凡姐
王人	王人
川氏	川氏
格哥	格哥
格氏	格氏
器人	器人
周哥	周哥
辰哥	辰哥
亲哥	亲哥
魂哥	魂哥
好哥	好哥
鑫爸	鑫爸
鱼姐	鱼姐
菡妈	菡妈
庆姐	庆姐
浦人	浦人
壳人	壳人
丽哥	丽哥
尜姐	尜姐
政哥	政哥
领哥	领哥
卡哥	卡哥
耀哥	耀哥
怒者	怒者
鼻哥	鼻哥
性人	性人
粤人	粤人
乃哥	乃哥
落者	落者
利妈	利妈
荒者	荒者
乾哥	乾哥
峰妈	峰妈
伟妈	伟妈
农氏	农氏
名哥	名哥
码人	码人
动者	动者
同哥	同哥
茵姐	茵姐
玩者	玩者
雷氏	雷氏
野者	野者
兜妈	兜妈
卫哥	卫哥
玮妈	玮妈
速人	速人
桐哥	桐哥
盈姐	盈姐
洛哥	洛哥
吾人	吾人
特人	特人
贝妈	贝妈
音者	音者
醉者	醉者
博爸	博爸
全人	全人
寒妈	寒妈
瑜爸	瑜爸
号人	号人
始人	始人
妤妈	妤妈
南妈	南妈
少哥	少哥
琳爸	琳爸
炜哥	炜哥
斯氏	斯氏
予者	予者
蓝哥	蓝哥
斯哥	斯哥
贼哥	贼哥
阳者	阳者
阴人	阴人
亭哥	亭哥
其哥	其哥
女姐	女姐
葛氏	葛氏
俊仔	俊仔
元妈	元妈
舟人	舟人
轩爸	轩爸
浩爸	浩爸
子氏	子氏
久哥	久哥
民人	民人
逸妈	逸妈
菲哥	菲哥
贝氏	贝氏
母人	母人
潭人	潭人
菜人	菜人
源氏	源氏
舞哥	舞哥
沙哥	沙哥
虾仔	虾仔
创人	创人
房人	房人
狗人	狗人
行妈	行妈
求哥	求哥
娜妈	娜妈
丫妈	丫妈
崽妈	崽妈
立哥	立哥
鸣哥	鸣哥
胡哥	胡哥
米爸	米爸
莫人	莫人
养哥	养哥
昊爸	昊爸
会者	会者
鸽人	鸽人
牙人	牙人
平妈	平妈
北哥	北哥
罗哥	罗哥
骑者	骑者
习者	习者
州仔	州仔
豆爸	豆爸
尚哥	尚哥
服者	服者
冷人	冷人
鬼者	鬼者
求者	求者
保哥	保哥
陵哥	陵哥
叔氏	叔氏
稼人	稼人
恶人	恶人
皮姐	皮姐
痴人	痴人
豆人	豆人
修者	修者
漂者	漂者
林爸	林爸
宜姐	宜姐
富人	富人
扬爸	扬爸
木仔	木仔
汉哥	汉哥
隐人	隐人
机人	机人
晶氏	晶氏
忆者	忆者
萨哥	萨哥
陌人	陌人
庸者	庸者
敏妈	敏妈
稻人	稻人
石哥	石哥
玮哥	玮哥
同妈	同妈
特妈	特妈
霏妈	霏妈
程哥	程哥
露哥	露哥
茹妈	茹妈
松妈	松妈
涵姐	涵姐
虫哥	虫哥
明妈	明妈
克妈	克妈
哈哥	哈哥
希爸	希爸
生氏	生氏
坡哥	坡哥
多妈	多妈
空姐	空姐
片哥	片哥
池人	池人
角人	角人
锐妈	锐妈
易哥	易哥
虎者	虎者
宁爸	宁爸
凌人	凌人
旅者	旅者
范氏	范氏
富姐	富姐
然者	然者
硕妈	硕妈
星妈	星妈
丁妈	丁妈
獒者	獒者
星姐	星姐
倩姐	倩姐
香哥	香哥
岩姐	岩姐
谷哥	谷哥
斌妈	斌妈
峰姐	峰姐
瑞爸	瑞爸
明氏	明氏
童妈	童妈
米姐	米姐
靖哥	靖哥
渡者	渡者
忘人	忘人
楼哥	楼哥
实者	实者
静妈	静妈
痞哥	痞哥
庸人	庸人
薇姐	薇姐
甸人	甸人
蝶人	蝶人
途者	途者
知哥	知哥
牛氏	牛氏
骏妈	骏妈
树哥	树哥
余人	余人
鸽哥	鸽哥
太人	太人
谦妈	谦妈
佑妈	佑妈
名者	名者
任氏	任氏
恩氏	恩氏
前者	前者
故人	故人
板哥	板哥
忆人	忆人
雅哥	雅哥
驴哥	驴哥
佐哥	佐哥
健妈	健妈
凡氏	凡氏
燕哥	燕哥
识人	识人
璞哥	璞哥
乡者	乡者
吧哥	吧哥
萱姐	萱姐
余哥	余哥
囝哥	囝哥
丽仔	丽仔
漂人	漂人
韵姐	韵姐
独者	独者
直人	直人
仪爸	仪爸
潘哥	潘哥
卓氏	卓氏
精哥	精哥
斯妈	斯妈
民者	民者
港哥	港哥
大者	大者
神氏	神氏
墓人	墓人
雪妈	雪妈
身人	身人
丘哥	丘哥
瓜哥	瓜哥
帆人	帆人
敦氏	敦氏
声哥	声哥
食者	食者
笨人	笨人
遥哥	遥哥
流哥	流哥
坡人	坡人
和氏	和氏
卿姐	卿姐
安姐	安姐
莉仔	莉仔
宸爸	宸爸
瑶爸	瑶爸
叉哥	叉哥
茶者	茶者
魅人	魅人
禹哥	禹哥
实哥	实哥
百者	百者
森妈	森妈
岳妈	岳妈
师氏	师氏
侨哥	侨哥
安妈	安妈
变人	变人
廷哥	廷哥
寡人	寡人
鹿人	鹿人
康妈	康妈
决者	决者
贱哥	贱哥
化哥	化哥
患者	患者
蔡氏	蔡氏
败者	败者
里妈	里妈
何氏	何氏
朗妈	朗妈
雾者	雾者
韬哥	韬哥
尼人	尼人
艺哥	艺哥
画者	画者
祥妈	祥妈
成爸	成爸
爱哥	爱哥
羞哥	羞哥
韩氏	韩氏
底人	底人
虾哥	虾哥
高哥	高哥
醉哥	醉哥
愁人	愁人
邱人	邱人
邦哥	邦哥
壮妈	壮妈
美氏	美氏
丽妈	丽妈
铮妈	铮妈
紫者	紫者
相哥	相哥
深哥	深哥
狂哥	狂哥
环姐	环姐
猛人	猛人
逐者	逐者
鸟氏	鸟氏
欣人	欣人
亮妈	亮妈
四妈	四妈
祖氏	祖氏
红氏	红氏
为者	为者
椒哥	椒哥
始者	始者
度哥	度哥
龄姐	龄姐
凝妈	凝妈
布哥	布哥
灯哥	灯哥
溪妈	溪妈
东妈	东妈
进者	进者
辉爸	辉爸
拙人	拙人
逗哥	逗哥
鲸人	鲸人
秋哥	秋哥
仙哥	仙哥
板人	板人
杯人	杯人
蓝姐	蓝姐
结者	结者
曼姐	曼姐
舟者	舟者
朵妈	朵妈
然人	然人
兔人	兔人
真姐	真姐
曼妈	曼妈
孤人	孤人
容妈	容妈
操哥	操哥
姣姐	姣姐
毅爸	毅爸
叶哥	叶哥
麦人	麦人
奶仔	奶仔
圆姐	圆姐
陇人	陇人
库哥	库哥
噶人	噶人
辣哥	辣哥
森氏	森氏
欢哥	欢哥
歌人	歌人
璐妈	璐妈
冰妈	冰妈
皮妈	皮妈
幻者	幻者
觅人	觅人
会哥	会哥
埔人	埔人
劲哥	劲哥
熊者	熊者
钕人	钕人
咪哥	咪哥
达者	达者
苗妈	苗妈
婷仔	婷仔
曲人	曲人
沙者	沙者
兴妈	兴妈
色人	色人
松姐	松姐
苗姐	苗姐
迪氏	迪氏
莲者	莲者
一爸	一爸
乔妈	乔妈
涧人	涧人
玲哥	玲哥
幽者	幽者
洒哥	洒哥
弟妈	弟妈
福氏	福氏
当哥	当哥
钱哥	钱哥
翔人	翔人
棋者	棋者
贺氏	贺氏
疆人	疆人
桑氏	桑氏
愚者	愚者
澳人	澳人
晶哥	晶哥
姓人	姓人
盐人	盐人
薇妈	薇妈
熊哥	熊哥
木者	木者
涉者	涉者
饶人	饶人
邮人	邮人
飞者	飞者
凌哥	凌哥
字哥	字哥
言爸	言爸
畅爸	畅爸
婧妈	婧妈
施哥	施哥
怪人	怪人
亿哥	亿哥
鹰者	鹰者
佛者	佛者
婵姐	婵姐
漫人	漫人
凡爸	凡爸
学哥	学哥
云妈	云妈
饼人	饼人
邵氏	邵氏
逝者	逝者
淡人	淡人
印哥	印哥
灿哥	灿哥
自人	自人
嘉姐	嘉姐
林者	林者
公哥	公哥
鹃姐	鹃姐
寸人	寸人
谢哥	谢哥
骄人	骄人
尼氏	尼氏
苑姐	苑姐
主者	主者
格人	格人
行哥	行哥
若妈	若妈
比爸	比爸
拉爸	拉爸
关哥	关哥
冉妈	冉妈
战哥	战哥
芳姐	芳姐
姆妈	姆妈
妞姐	妞姐
旋哥	旋哥
氏者	氏者
零人	零人
虎仔	虎仔
忧者	忧者
阁人	阁人
鑫姐	鑫姐
户人	户人
笑妈	笑妈
麦者	麦者
平氏	平氏
真哥	真哥
乔哥	乔哥
彭氏	彭氏
潇哥	潇哥
阁哥	阁哥
寅哥	寅哥
村哥	村哥
肚哥	肚哥
古者	古者
恒爸	恒爸
阿爸	阿爸
欢姐	欢姐
靓哥	靓哥
竹哥	竹哥
姿姐	姿姐
余氏	余氏
派哥	派哥
媛妈	媛妈
闯哥	闯哥
史氏	史氏
云姐	云姐
苏哥	苏哥
言哥	言哥
妖哥	妖哥
线人	线人
派人	派人
戴氏	戴氏
六姐	六姐
永氏	永氏
包仔	包仔
前哥	前哥
霸者	霸者
巷人	巷人
二爸	二爸
伊氏	伊氏
根哥	根哥
露妈	露妈
巢氏	巢氏
熠妈	熠妈
引者	引者
妮爸	妮爸
界人	界人
为妈	为妈
漫姐	漫姐
麟哥	麟哥
男妈	男妈
盗人	盗人
鸽者	鸽者
秋妈	秋妈
尧妈	尧妈
庙人	庙人
李人	李人
佑哥	佑哥
往者	往者
辣妈	辣妈
竹者	竹者
点人	点人
正氏	正氏
蕾哥	蕾哥
尘者	尘者
航人	航人
琛哥	琛哥
兰妈	兰妈
听者	听者
条人	条人
辽人	辽人
纹人	纹人
越者	越者
流者	流者
谒者	谒者
菊哥	菊哥
撒哥	撒哥
饼哥	饼哥
考者	考者
术者	术者
啊姐	啊姐
侠哥	侠哥
朗人	朗人
岩哥	岩哥
万人	万人
向人	向人
梦仔	梦仔
洲妈	洲妈
善哥	善哥
萧哥	萧哥
寒氏	寒氏
随者	随者
媛氏	媛氏
彤姐	彤姐
数人	数人
曾哥	曾哥
罪者	罪者
宽哥	宽哥
尹氏	尹氏
调哥	调哥
涛爸	涛爸
恩妈	恩妈
董哥	董哥
旧人	旧人
变者	变者
岸哥	岸哥
淼姐	淼姐
黄哥	黄哥
岭哥	岭哥
服人	服人
常哥	常哥
远者	远者
晓妈	晓妈
瀚妈	瀚妈
天妈	天妈
勒哥	勒哥
棋人	棋人
啊爸	啊爸
城妈	城妈
堂哥	堂哥
邱氏	邱氏
拉妈	拉妈
能者	能者
帅姐	帅姐
泡仔	泡仔
麻人	麻人
得哥	得哥
水氏	水氏
珊妈	珊妈
运哥	运哥
崖人	崖人
公仔	公仔
淳妈	淳妈
飘者	飘者
妖人	妖人
昊哥	昊哥
材哥	材哥
目人	目人
猫人	猫人
泊人	泊人
淇哥	淇哥
章人	章人
颖爸	颖爸
静哥	静哥
羲氏	羲氏
暖人	暖人
留人	留人
微姐	微姐
斗哥	斗哥
尼姐	尼姐
郎妈	郎妈
灯者	灯者
同人	同人
亭人	亭人
诺者	诺者
灵妈	灵妈
教者	教者
玲妈	玲妈
忙哥	忙哥
锋者	锋者
齐氏	齐氏
潮哥	潮哥
源姐	源姐
赫氏	赫氏
了人	了人
药哥	药哥
锐哥	锐哥
泽爸	泽爸
琴姐	琴姐
莱人	莱人
霄哥	霄哥
领者	领者
曦氏	曦氏
脸哥	脸哥
思妈	思妈
松者	松者
铺人	铺人
顿妈	顿妈
骂人	骂人
篮人	篮人
迪姐	迪姐
尾人	尾人
艺妈	艺妈
拜人	拜人
意者	意者
和妈	和妈
禹妈	禹妈
盈妈	盈妈
曲哥	曲哥
七仔	七仔
泳者	泳者
呵人	呵人
相者	相者
京哥	京哥
旁人	旁人
兄哥	兄哥
边哥	边哥
君妈	君妈
锦妈	锦妈
孤者	孤者
练者	练者
赖人	赖人
园者	园者
媚人	媚人
裕妈	裕妈
魏哥	魏哥
铭姐	铭姐
赎者	赎者
钰爸	钰爸
特爸	特爸
由哥	由哥
村氏	村氏
帆爸	帆爸
相氏	相氏
哲爸	哲爸
皓哥	皓哥
性者	性者
舒姐	舒姐
眼人	眼人
谎者	谎者
至者	至者
顺人	顺人
漫者	漫者
铃哥	铃哥
竹姐	竹姐
奴人	奴人
旻妈	旻妈
岳哥	岳哥
富者	富者
野妈	野妈
邀人	邀人
华姐	华姐
摔哥	摔哥
庆妈	庆妈
尔爸	尔爸
购者	购者
原氏	原氏
导者	导者
晖姐	晖姐
茂哥	茂哥
师人	师人
桑人	桑人
楚氏	楚氏
树妈	树妈
牛姐	牛姐
波仔	波仔
憨哥	憨哥
叫哥	叫哥
虞氏	虞氏
鼓人	鼓人
岩者	岩者
许哥	许哥
宗哥	宗哥
晶妈	晶妈
雪哥	雪哥
莫哥	莫哥
苍哥	苍哥
莫氏	莫氏
朵姐	朵姐
干氏	干氏
根仔	根仔
厝人	厝人
整哥	整哥
盲哥	盲哥
环人	环人
懿妈	懿妈
血者	血者
婕妈	婕妈
镇哥	镇哥
网者	网者
趣人	趣人
优妈	优妈
蒂妈	蒂妈
桦姐	桦姐
基氏	基氏
伶人	伶人
吉氏	吉氏
崔氏	崔氏
隼人	隼人
煤人	煤人
则者	则者
刃人	刃人
渊哥	渊哥
界者	界者
其姐	其姐
嫣妈	嫣妈
诺氏	诺氏
纳氏	纳氏
鹰人	鹰人
令人	令人
苔哥	苔哥
吟姐	吟姐
荒人	荒人
元氏	元氏
庭哥	庭哥
岚氏	岚氏
观哥	观哥
禾哥	禾哥
欲者	欲者
弦者	弦者
奇爸	奇爸
鸡人	鸡人
莫者	莫者
元爸	元爸
居人	居人
言姐	言姐
璐人	璐人
熊人	熊人
家爸	家爸
殷氏	殷氏
机者	机者
沈氏	沈氏
薇人	薇人
了哥	了哥
氓哥	氓哥
杰者	杰者
呈妈	呈妈
虫人	虫人
豆氏	豆氏
芳者	芳者
炎哥	炎哥
蜂人	蜂人
妍爸	妍爸
诺哥	诺哥
泼哥	泼哥
掌哥	掌哥
盼哥	盼哥
性氏	性氏
戏人	戏人
朱哥	朱哥
肚人	肚人
论者	论者
读者	读者
沐妈	沐妈
娜爸	娜爸
青爸	青爸
尧氏	尧氏
舟哥	舟哥
秀哥	秀哥
精人	精人
杉哥	杉哥
旺氏	旺氏
胖姐	胖姐
雪氏	雪氏
羽姐	羽姐
茗妈	茗妈
丹氏	丹氏
遥姐	遥姐
驿人	驿人
墘人	墘人
杭妈	杭妈
龄人	龄人
弓人	弓人
枫妈	枫妈
邻人	邻人
恩姐	恩姐
叶妈	叶妈
原妈	原妈
职人	职人
腾妈	腾妈
宋哥	宋哥
龚氏	龚氏
萨妈	萨妈
指哥	指哥
吟者	吟者
过哥	过哥
旺爸	旺爸
庄哥	庄哥
急人	急人
巡者	巡者
婷爸	婷爸
军妈	军妈
彩妈	彩妈
棋妈	棋妈
冬妈	冬妈
卞氏	卞氏
夷人	夷人
有哥	有哥
姬人	姬人
玩哥	玩哥
图哥	图哥
希哥	希哥
财妈	财妈
衰哥	衰哥
钻人	钻人
露姐	露姐
试人	试人
钰姐	钰姐
勒人	勒人
晒哥	晒哥
家氏	家氏
悟者	悟者
柔氏	柔氏
感哥	感哥
庆仔	庆仔
培姐	培姐
卵哥	卵哥
家者	家者
狮人	狮人
击者	击者
理者	理者
希氏	希氏
悦氏	悦氏
贵妈	贵妈
除人	除人
董氏	董氏
草者	草者
参人	参人
姐哥	姐哥
靠哥	靠哥
麦氏	麦氏
几哥	几哥
季氏	季氏
治哥	治哥
郎者	郎者
示人	示人
晗爸	晗爸
卫氏	卫氏
娟哥	娟哥
奋哥	奋哥
鸭哥	鸭哥
约者	约者
缘哥	缘哥
枝哥	枝哥
熟人	熟人
潮人	潮人
来爸	来爸
党哥	党哥
唐哥	唐哥
波氏	波氏
开人	开人
奥爸	奥爸
肆哥	肆哥
汤哥	汤哥
坤妈	坤妈
象人	象人
澎哥	澎哥
超爸	超爸
峰爸	峰爸
兴氏	兴氏
钦妈	钦妈
不人	不人
薇氏	薇氏
上哥	上哥
一者	一者
獒人	獒人
丘人	丘人
蠢人	蠢人
戈氏	戈氏
丁爸	丁爸
您妈	您妈
霖姐	霖姐
滴姐	滴姐
单哥	单哥
凉人	凉人
初哥	初哥
邪哥	邪哥
蜜哥	蜜哥
西氏	西氏
斐哥	斐哥
远姐	远姐
单氏	单氏
雁姐	雁姐
鸣妈	鸣妈
上氏	上氏
足人	足人
葱哥	葱哥
洛氏	洛氏
陶人	陶人
栖者	栖者
警人	警人
翼妈	翼妈
女妈	女妈
途人	途人
康氏	康氏
屏人	屏人
庐人	庐人
莱哥	莱哥
伦姐	伦姐
侯者	侯者
之爸	之爸
股者	股者
赫哥	赫哥
桶哥	桶哥
穴人	穴人
井氏	井氏
末人	末人
上者	上者
卯人	卯人
教人	教人
烟哥	烟哥
僧哥	僧哥
苹姐	苹姐
义氏	义氏
经者	经者
肤人	肤人
尾哥	尾哥
哑人	哑人
态人	态人
黎氏	黎氏
莲妈	莲妈
弟人	弟人
员哥	员哥
韵妈	韵妈
境人	境人
拳人	拳人
岁哥	岁哥
烨哥	烨哥
刘哥	刘哥
坨妈	坨妈
在者	在者
奥人	奥人
霞人	霞人
兔姐	兔姐
莉妈	莉妈
普哥	普哥
漠人	漠人
鼎哥	鼎哥
昕哥	昕哥
麽人	麽人
喇氏	喇氏
奥氏	奥氏
家妈	家妈
瘦哥	瘦哥
那哥	那哥
任人	任人
调者	调者
紫哥	紫哥
爵哥	爵哥
温氏	温氏
冉哥	冉哥
其妈	其妈
沛哥	沛哥
鞭哥	鞭哥
霍氏	霍氏
伍氏	伍氏
吊哥	吊哥
信妈	信妈
步人	步人
斌姐	斌姐
番哥	番哥
氧人	氧人
功者	功者
弛人	弛人
皇哥	皇哥
为哥	为哥
匠哥	匠哥
穗人	穗人
活者	活者
瑶哥	瑶哥
执者	执者
域者	域者
勤哥	勤哥
衣者	衣者
务者	务者
虎爸	虎爸
材人	材人
铖妈	铖妈
垦人	垦人
翼哥	翼哥
圣氏	圣氏
朱姐	朱姐
游氏	游氏
桑哥	桑哥
月仔	月仔
工者	工者
华氏	华氏
习哥	习哥
糖哥	糖哥
府哥	府哥
如妈	如妈
勇妈	勇妈
龟哥	龟哥
舞人	舞人
清氏	清氏
令哥	令哥
音姐	音姐
新者	新者
峻哥	峻哥
轩姐	轩姐
鹿者	鹿者
斐妈	斐妈
魁哥	魁哥
盲人	盲人
泥妈	泥妈
诺爸	诺爸
钱者	钱者
方哥	方哥
儒哥	儒哥
心氏	心氏
美妈	美妈
邓氏	邓氏
苏姐	苏姐
思氏	思氏
净人	净人
萌哥	萌哥
邑人	邑人
猴人	猴人
力妈	力妈
标人	标人
润妈	润妈
皇者	皇者
华爸	华爸
英妈	英妈
岙人	岙人
甩哥	甩哥
暴哥	暴哥
模者	模者
卡妈	卡妈
博者	博者
愿者	愿者
财者	财者
丰氏	丰氏
洋爸	洋爸
娃爸	娃爸
彩哥	彩哥
具人	具人
棋哥	棋哥
越爸	越爸
犬者	犬者
韦氏	韦氏
蒙姐	蒙姐
寐人	寐人
犯人	犯人
响哥	响哥
展哥	展哥
静爸	静爸
威姐	威姐
栖人	栖人
贝哥	贝哥
涂人	涂人
洁氏	洁氏
翰哥	翰哥
位者	位者
陈哥	陈哥
驾者	驾者
恨哥	恨哥
拉仔	拉仔
璐姐	璐姐
技者	技者
嫣爸	嫣爸
峰者	峰者
柳姐	柳姐
仁妈	仁妈
昂哥	昂哥
腾哥	腾哥
于哥	于哥
后氏	后氏
艳仔	艳仔
竟人	竟人
鼠妈	鼠妈
圣哥	圣哥
杏姐	杏姐
笛者	笛者
蛋人	蛋人
祝氏	祝氏
每人	每人
鸡姐	鸡姐
黑者	黑者
鄂氏	鄂氏
恩人	恩人
虐者	虐者
头者	头者
拓人	拓人
蓓妈	蓓妈
令者	令者
饭哥	饭哥
翻哥	翻哥
皓爸	皓爸
珠爸	珠爸
蛙哥	蛙哥
宰哥	宰哥
翊妈	翊妈
太哥	太哥
名妈	名妈
获者	获者
露氏	露氏
遇人	遇人
奶哥	奶哥
羊哥	羊哥
雷妈	雷妈
面者	面者
端哥	端哥
蝎人	蝎人
恺妈	恺妈
涛姐	涛姐
祺哥	祺哥
量人	量人
锋姐	锋姐
陵者	陵者
甫哥	甫哥
冶氏	冶氏
归者	归者
蜂哥	蜂哥
彦氏	彦氏
纳人	纳人
型者	型者
蜜人	蜜人
妖姐	妖姐
帝者	帝者
蔚姐	蔚姐
日者	日者
侃哥	侃哥
玩人	玩人
晴姐	晴姐
叮妈	叮妈
思哥	思哥
极人	极人
维氏	维氏
猫姐	猫姐
笔哥	笔哥
孟哥	孟哥
尹妈	尹妈
诚者	诚者
淮人	淮人
密哥	密哥
昱妈	昱妈
酷人	酷人
容者	容者
宣哥	宣哥
阿姐	阿姐
望哥	望哥
肖哥	肖哥
灌氏	灌氏
郎人	郎人
秀妈	秀妈
涵哥	涵哥
日氏	日氏
番人	番人
枪哥	枪哥
山仔	山仔
眠人	眠人
岛氏	岛氏
冒哥	冒哥
古仔	古仔
打人	打人
巴妈	巴妈
禅者	禅者
图氏	图氏
伦氏	伦氏
妞爸	妞爸
熟者	熟者
脑人	脑人
棉人	棉人
黎姐	黎姐
陶妈	陶妈
丑哥	丑哥
衡者	衡者
僧人	僧人
卷哥	卷哥
烟人	烟人
查哥	查哥
谣人	谣人
遇者	遇者
宦者	宦者
小爸	小爸
吓人	吓人
读人	读人
姿妈	姿妈
昔者	昔者
么人	么人
葵哥	葵哥
哩人	哩人
迩妈	迩妈
坦人	坦人
恒仔	恒仔
琴人	琴人
辛哥	辛哥
合人	合人
师者	师者
奇氏	奇氏
疯人	疯人
糖人	糖人
澧人	澧人
挺哥	挺哥
爽妈	爽妈
兽人	兽人
捷妈	捷妈
批哥	批哥
式哥	式哥
钟氏	钟氏
卜氏	卜氏
妹哥	妹哥
氏人	氏人
之妈	之妈
履者	履者
杯者	杯者
誉妈	誉妈
厚哥	厚哥
郊人	郊人
堂姐	堂姐
壹人	壹人
驮哥	驮哥
灰人	灰人
承妈	承妈
起哥	起哥
境者	境者
田哥	田哥
钟哥	钟哥
可爸	可爸
滔哥	滔哥
陀妈	陀妈
鸿姐	鸿姐
呆人	呆人
盟者	盟者
蒂哥	蒂哥
霖爸	霖爸
坪人	坪人
丝人	丝人
童爸	童爸
慧哥	慧哥
摩哥	摩哥
强妈	强妈
鸿妈	鸿妈
依妈	依妈
美哥	美哥
拓哥	拓哥
寂者	寂者
嘉哥	嘉哥
嫁人	嫁人
冻人	冻人
残者	残者
倪妈	倪妈
宏哥	宏哥
诗妈	诗妈
煞人	煞人
票人	票人
嘉氏	嘉氏
侍者	侍者
密者	密者
怡氏	怡氏
蛇者	蛇者
财人	财人
技人	技人
民氏	民氏
勤姐	勤姐
卉姐	卉姐
虹哥	虹哥
笔者	笔者
儿人	儿人
石氏	石氏
山妈	山妈
寿哥	寿哥
邢者	邢者
客者	客者
套哥	套哥
艺者	艺者
十姐	十姐
润哥	润哥
辰姐	辰姐
眉姐	眉姐
仔姐	仔姐
号哥	号哥
罗姐	罗姐
夏人	夏人
梦姐	梦姐
韦哥	韦哥
屯氏	屯氏
棍者	棍者
迁人	迁人
发者	发者
进人	进人
景哥	景哥
冲者	冲者
冥者	冥者
咏哥	咏哥
淼哥	淼哥
鹤者	鹤者
苦人	苦人
了妈	了妈
具者	具者
冠哥	冠哥
都哥	都哥
挥人	挥人
竿哥	竿哥
渊妈	渊妈
怀氏	怀氏
说者	说者
市姐	市姐
凤妈	凤妈
朋爸	朋爸
凡哥	凡哥
都氏	都氏
谜人	谜人
杭爸	杭爸
粲妈	粲妈
专人	专人
茵者	茵者
媒人	媒人
印人	印人
迹哥	迹哥
闻哥	闻哥
邹哥	邹哥
公人	公人
四者	四者
景氏	景氏
鄙人	鄙人
雕人	雕人
主哥	主哥
魔哥	魔哥
桓氏	桓氏
墙人	墙人
斯姐	斯姐
桦哥	桦哥
晟哥	晟哥
岛者	岛者
且哥	且哥
叹哥	叹哥
徐哥	徐哥
单人	单人
凝爸	凝爸
翼姐	翼姐
海妈	海妈
汀人	汀人
怡哥	怡哥
升人	升人
宏氏	宏氏
薛氏	薛氏
逗人	逗人
利爸	利爸
愿人	愿人
柔姐	柔姐
鑫者	鑫者
柒哥	柒哥
漂哥	漂哥
可氏	可氏
仕哥	仕哥
化者	化者
逃人	逃人
惹人	惹人
暴者	暴者
笛人	笛人
高爸	高爸
甘哥	甘哥
点妈	点妈
亲妈	亲妈
大氏	大氏
鸥哥	鸥哥
敏爸	敏爸
闭哥	闭哥
街者	街者
罗妈	罗妈
毛氏	毛氏
跑者	跑者
朵人	朵人
住哥	住哥
伟爸	伟爸
程人	程人
沙姐	沙姐
慈哥	慈哥
珠哥	珠哥
男爸	男爸
略者	略者
照哥	照哥
喆哥	喆哥
研者	研者
朗姐	朗姐
遥者	遥者
恩者	恩者
气者	气者
捷爸	捷爸
达姐	达姐
理妈	理妈
湿哥	湿哥
史人	史人
珂妈	珂妈
梁妈	梁妈
玺妈	玺妈
映姐	映姐
卉妈	卉妈
音人	音人
量哥	量哥
蕾姐	蕾姐
琳哥	琳哥
嗵人	嗵人
汪哥	汪哥
邪者	邪者
警哥	警哥
美者	美者
你哥	你哥
级哥	级哥
熊姐	熊姐
兰爸	兰爸
巾者	巾者
莫妈	莫妈
寮人	寮人
筑人	筑人
任者	任者
卜哥	卜哥
麒哥	麒哥
情姐	情姐
茶哥	茶哥
露仔	露仔
才者	才者
贾氏	贾氏
城氏	城氏
提哥	提哥
澜人	澜人
钧哥	钧哥
齐爸	齐爸
百哥	百哥
帮人	帮人
府人	府人
严哥	严哥
行爸	行爸
垛人	垛人
扬姐	扬姐
堂妈	堂妈
号者	号者
雨爸	雨爸
凡者	凡者
微哥	微哥
张姐	张姐
裤哥	裤哥
友者	友者
蕊妈	蕊妈
蕊姐	蕊姐
坠人	坠人
稳人	稳人
黔人	黔人
洋姐	洋姐
可者	可者
姚哥	姚哥
巨哥	巨哥
角哥	角哥
杜哥	杜哥
谦爸	谦爸
叫姐	叫姐
莹哥	莹哥
莱姐	莱姐
芮妈	芮妈
刀氏	刀氏
逝人	逝人
枫姐	枫姐
牙者	牙者
卫姐	卫姐
索人	索人
艺氏	艺氏
宪哥	宪哥
越姐	越姐
粮哥	粮哥
妹者	妹者
奴姐	奴姐
赖姐	赖姐
城者	城者
吻人	吻人
幺姐	幺姐
袍人	袍人
威者	威者
丸哥	丸哥
辛氏	辛氏
又哥	又哥
静姐	静姐
翌妈	翌妈
色者	色者
带哥	带哥
宝姐	宝姐
书氏	书氏
璇者	璇者
咯哥	咯哥
晶人	晶人
犁人	犁人
想妈	想妈
狄人	狄人
校哥	校哥
霜哥	霜哥
缨姐	缨姐
奈氏	奈氏
莫爸	莫爸
杉人	杉人
博姐	博姐
慧者	慧者
列人	列人
优者	优者
防人	防人
囡人	囡人
闸人	闸人
回者	回者
杰爸	杰爸
容哥	容哥
虎氏	虎氏
幽人	幽人
觉氏	觉氏
浩仔	浩仔
仲氏	仲氏
卿妈	卿妈
谊姐	谊姐
孔哥	孔哥
宜爸	宜爸
腾者	腾者
台哥	台哥
柳爸	柳爸
焦哥	焦哥
丰妈	丰妈
觉哥	觉哥
曼氏	曼氏
欲人	欲人
隐哥	隐哥
孩哥	孩哥
蓬哥	蓬哥
淳哥	淳哥
但姐	但姐
菇人	菇人
帝氏	帝氏
摩人	摩人
远爸	远爸
拉者	拉者
延姐	延姐
甄氏	甄氏
当人	当人
序者	序者
谷氏	谷氏
陋人	陋人
耳氏	耳氏
驼人	驼人
模人	模人
语姐	语姐
番仔	番仔
馗哥	馗哥
登人	登人
桃爸	桃爸
蔡哥	蔡哥
西妈	西妈
舟妈	舟妈
由妈	由妈
职者	职者
哒人	哒人
范哥	范哥
兔者	兔者
畔人	畔人
邓哥	邓哥
玄哥	玄哥
字人	字人
狐人	狐人
苗爸	苗爸
吃哥	吃哥
岩妈	岩妈
劫者	劫者
岛哥	岛哥
盈哥	盈哥
窝人	窝人
引人	引人
逢哥	逢哥
霞妈	霞妈
时氏	时氏
屿人	屿人
询人	询人
阙人	阙人
翼爸	翼爸
赤哥	赤哥
喜妈	喜妈
臣妈	臣妈
菁妈	菁妈
炫者	炫者
罗仔	罗仔
妍氏	妍氏
璐者	璐者
和者	和者
恺哥	恺哥
幕者	幕者
辣人	辣人
书者	书者
集者	集者
顿哥	顿哥
卡氏	卡氏
君氏	君氏
涂妈	涂妈
聋哥	聋哥
鲁爸	鲁爸
祢妈	祢妈
南爸	南爸
汤姐	汤姐
驰哥	驰哥
问人	问人
鑫氏	鑫氏
赢者	赢者
炅妈	炅妈
祖妈	祖妈
红妈	红妈
盖哥	盖哥
霍人	霍人
咸哥	咸哥
蒙人	蒙人
意姐	意姐
戴哥	戴哥
精者	精者
爱氏	爱氏
图者	图者
坎人	坎人
禾爸	禾爸
熙爸	熙爸
够哥	够哥
莽人	莽人
客氏	客氏
斤人	斤人
南者	南者
猩人	猩人
禁者	禁者
意妈	意妈
明爸	明爸
宽妈	宽妈
玖哥	玖哥
侯人	侯人
荔氏	荔氏
多爸	多爸
愚哥	愚哥
池哥	池哥
幼仔	幼仔
贤爸	贤爸
奔氏	奔氏
馨爸	馨爸
益哥	益哥
佰氏	佰氏
隋氏	隋氏
亮姐	亮姐
雷姐	雷姐
恩爸	恩爸
无哥	无哥
物者	物者
迟氏	迟氏
留者	留者
宜仔	宜仔
本氏	本氏
琴妈	琴妈
帆者	帆者
舍者	舍者
侬人	侬人
夏妈	夏妈
月妈	月妈
吟人	吟人
蓓姐	蓓姐
亲姐	亲姐
排者	排者
廖哥	廖哥
粱哥	粱哥
维妈	维妈
身者	身者
顺妈	顺妈
俏哥	俏哥
惠哥	惠哥
培哥	培哥
巴爸	巴爸
禄氏	禄氏
格妈	格妈
蔡姐	蔡姐
样哥	样哥
毒人	毒人
蔚妈	蔚妈
岚妈	岚妈
豹人	豹人
烤者	烤者
丝哥	丝哥
禄哥	禄哥
条姐	条姐
左者	左者
平爸	平爸
无氏	无氏
弘妈	弘妈
镖者	镖者
使人	使人
庚哥	庚哥
占哥	占哥
榕氏	榕氏
娴妈	娴妈
语哥	语哥
勋妈	勋妈
里爸	里爸
果爸	果爸
罗者	罗者
刑者	刑者
且人	且人
莎姐	莎姐
探者	探者
龟者	龟者
先者	先者
誓者	誓者
彭人	彭人
袋哥	袋哥
屯人	屯人
穆哥	穆哥
桔者	桔者
尼爸	尼爸
叶氏	叶氏
李姐	李姐
足仔	足仔
郭人	郭人
翁哥	翁哥
组人	组人
雁哥	雁哥
晟妈	晟妈
麻氏	麻氏
蓬人	蓬人
宵人	宵人
俊爸	俊爸
狄氏	狄氏
磊爸	磊爸
赖哥	赖哥
忆哥	忆哥
溟者	溟者
王姐	王姐
茜妈	茜妈
城仔	城仔
颜哥	颜哥
土者	土者
额人	额人
拜哥	拜哥
莎妈	莎妈
琛妈	琛妈
团妈	团妈
扁哥	扁哥
嘻哥	嘻哥
昭氏	昭氏
食人	食人
贡人	贡人
默姐	默姐
於人	於人
宗氏	宗氏
其爸	其爸
中妈	中妈
江氏	江氏
克爸	克爸
巫人	巫人
勒妈	勒妈
虾人	虾人
蒙妈	蒙妈
拔氏	拔氏
弃者	弃者
诺人	诺人
敦哥	敦哥
塞人	塞人
祁妈	祁妈
钻姐	钻姐
哈人	哈人
柏妈	柏妈
队人	队人
无者	无者
莽哥	莽哥
衣哥	衣哥
呢哥	呢哥
戈爸	戈爸
拔哥	拔哥
属人	属人
羊者	羊者
辉者	辉者
暴人	暴人
忻氏	忻氏
秦者	秦者
杭哥	杭哥
峪人	峪人
鲁妈	鲁妈
士仔	士仔
闭者	闭者
仙者	仙者
谭姐	谭姐
未人	未人
斗人	斗人
同爸	同爸
强爸	强爸
恬妈	恬妈
先哥	先哥
晚人	晚人
诗爸	诗爸
保氏	保氏
缘妈	缘妈
长仔	长仔
艺姐	艺姐
逆者	逆者
伏者	伏者
熙氏	熙氏
娃人	娃人
困者	困者
唐姐	唐姐
备者	备者
御姐	御姐
嘟妈	嘟妈
礼人	礼人
根妈	根妈
冠妈	冠妈
哲姐	哲姐
傲妈	傲妈
敏姐	敏姐
通妈	通妈
月姐	月姐
园哥	园哥
脂人	脂人
而哥	而哥
萱爸	萱爸
泪者	泪者
牧妈	牧妈
悦爸	悦爸
霉人	霉人
痕哥	痕哥
洛妈	洛妈
萍哥	萍哥
荷妈	荷妈
纯哥	纯哥
双妈	双妈
烽哥	烽哥
剑仔	剑仔
商者	商者
弟姐	弟姐
络人	络人
真妈	真妈
爆哥	爆哥
乘氏	乘氏
兀者	兀者
盘人	盘人
妃姐	妃姐
毕人	毕人
韵者	韵者
渠人	渠人
常氏	常氏
么哥	么哥
霸人	霸人
桃哥	桃哥
坦哥	坦哥
窗人	窗人
别哥	别哥
丸人	丸人
初妈	初妈
步哥	步哥
摩者	摩者
愉哥	愉哥
围人	围人
梵人	梵人
宫氏	宫氏
朋妈	朋妈
沐哥	沐哥
好爸	好爸
路妈	路妈
玛哥	玛哥
非人	非人
盛氏	盛氏
朱妈	朱妈
哄人	哄人
品哥	品哥
实人	实人
谋者	谋者
雅爸	雅爸
冈哥	冈哥
带人	带人
碧人	碧人
电哥	电哥
坦氏	坦氏
列哥	列哥
韵氏	韵氏
穆者	穆者
茫人	茫人
咯人	咯人
壶妈	壶妈
势者	势者
妞哥	妞哥
棚哥	棚哥
临者	临者
叶者	叶者
喻氏	喻氏
刘姐	刘姐
元仔	元仔
谋哥	谋哥
骏爸	骏爸
莹爸	莹爸
钱氏	钱氏
洁者	洁者
镜哥	镜哥
商哥	商哥
禹爸	禹爸
枫者	枫者
雁氏	雁氏
简妈	简妈
帅爸	帅爸
虎人	虎人
忍人	忍人
狄哥	狄哥
颜者	颜者
正爸	正爸
姆人	姆人
郝氏	郝氏
见人	见人
拜者	拜者
变哥	变哥
碧爸	碧爸
才妈	才妈
汕人	汕人
晶爸	晶爸
善氏	善氏
排哥	排哥
喻者	喻者
讯哥	讯哥
贝者	贝者
忘者	忘者
管人	管人
考人	考人
驱者	驱者
斯爸	斯爸
层人	层人
圆妈	圆妈
牌哥	牌哥
堃哥	堃哥
鳖者	鳖者
献氏	献氏
威爸	威爸
煜爸	煜爸
沙氏	沙氏
黄人	黄人
竹妈	竹妈
应人	应人
良妈	良妈
服哥	服哥
戈妈	戈妈
休人	休人
彩者	彩者
源者	源者
秀仔	秀仔
晓氏	晓氏
博氏	博氏
淇姐	淇姐
爰氏	爰氏
俞哥	俞哥
躁哥	躁哥
直哥	直哥
延哥	延哥
爆者	爆者
劳者	劳者
儒者	儒者
裴氏	裴氏
兑哥	兑哥
渣哥	渣哥
土氏	土氏
钰哥	钰哥
挂者	挂者
研哥	研哥
爵氏	爵氏
荣氏	荣氏
刃者	刃者
长妈	长妈
福爸	福爸
地者	地者
呋人	呋人
桃姐	桃姐
程爸	程爸
万氏	万氏
如哥	如哥
巍姐	巍姐
泣者	泣者
笙哥	笙哥
北妈	北妈
凯人	凯人
煞哥	煞哥
语爸	语爸
包姐	包姐
峙人	峙人
巢者	巢者
告哥	告哥
菇姐	菇姐
籽妈	籽妈
厦人	厦人
顾氏	顾氏
平者	平者
搭哥	搭哥
凹人	凹人
嗯妈	嗯妈
干姐	干姐
尖哥	尖哥
毛仔	毛仔
经哥	经哥
安爸	安爸
芒氏	芒氏
艳爸	艳爸
想爸	想爸
珍哥	珍哥
潘氏	潘氏
囿人	囿人
锟哥	锟哥
当妈	当妈
隽妈	隽妈
焦人	焦人
国者	国者
脉人	脉人
融妈	融妈
雕哥	雕哥
闹人	闹人
戎姐	戎姐
凌爸	凌爸
叁姐	叁姐
延妈	延妈
翔氏	翔氏
目哥	目哥
蝈者	蝈者
瑟人	瑟人
贼者	贼者
腊姐	腊姐
乌哥	乌哥
懂哥	懂哥
凌妈	凌妈
九妈	九妈
戒者	戒者
驰人	驰人
力者	力者
玉氏	玉氏
洛者	洛者
婕氏	婕氏
发仔	发仔
沙妈	沙妈
向氏	向氏
韩人	韩人
严氏	严氏
访者	访者
装人	装人
烈者	烈者
童姐	童姐
信氏	信氏
琅者	琅者
背人	背人
弥妈	弥妈
懿哥	懿哥
冥人	冥人
藻人	藻人
真者	真者
雁妈	雁妈
森爸	森爸
添妈	添妈
夫妈	夫妈
矮哥	矮哥
书妈	书妈
壶哥	壶哥
嘎哥	嘎哥
婉姐	婉姐
撕哥	撕哥
底哥	底哥
部人	部人
阿者	阿者
砣妈	砣妈
怜人	怜人
馨者	馨者
德妈	德妈
城爸	城爸
萧氏	萧氏
力氏	力氏
雷者	雷者
鼓哥	鼓哥
报人	报人
绮妈	绮妈
渎人	渎人
言氏	言氏
吕人	吕人
呆哥	呆哥
威仔	威仔
与者	与者
丫哥	丫哥
章哥	章哥
代人	代人
识者	识者
茵妈	茵妈
奋者	奋者
拉人	拉人
阿氏	阿氏
烈哥	烈哥
级人	级人
磊人	磊人
终人	终人
晴氏	晴氏
什哥	什哥
摄者	摄者
匹哥	匹哥
逸者	逸者
把哥	把哥
锁哥	锁哥
货人	货人
事哥	事哥
闭人	闭人
唱者	唱者
项哥	项哥
真氏	真氏
艾爸	艾爸
立妈	立妈
甘人	甘人
翠姐	翠姐
抚者	抚者
朱人	朱人
瑛哥	瑛哥
雯爸	雯爸
晓爸	晓爸
桃妈	桃妈
菜妈	菜妈
省者	省者
刘人	刘人
爱仔	爱仔
双人	双人
颂哥	颂哥
话者	话者
隆妈	隆妈
井哥	井哥
杨爸	杨爸
尉氏	尉氏
眯哥	眯哥
四人	四人
优爸	优爸
忽哥	忽哥
祈爸	祈爸
坤姐	坤姐
室人	室人
澜氏	澜氏
夏者	夏者
芳妈	芳妈
果者	果者
仰者	仰者
妃哥	妃哥
龙爸	龙爸
宿者	宿者
翅人	翅人
关人	关人
崎哥	崎哥
震哥	震哥
错人	错人
虹氏	虹氏
盐姐	盐姐
傲哥	傲哥
郁哥	郁哥
锡哥	锡哥
同者	同者
虞人	虞人
魅姐	魅姐
碧仔	碧仔
英氏	英氏
房姐	房姐
纳妈	纳妈
仪哥	仪哥
泡哥	泡哥
扎氏	扎氏
门者	门者
针者	针者
正者	正者
成姐	成姐
端妈	端妈
将者	将者
钊妈	钊妈
竿人	竿人
卜人	卜人
熹哥	熹哥
脚仔	脚仔
复者	复者
根氏	根氏
楼氏	楼氏
柱妈	柱妈
半人	半人
奇姐	奇姐
炭哥	炭哥
帽哥	帽哥
葵人	葵人
玮姐	玮姐
顺氏	顺氏
骝仔	骝仔
霸爸	霸爸
解者	解者
旺者	旺者
猗氏	猗氏
争人	争人
季哥	季哥
帮哥	帮哥
钗姐	钗姐
渚人	渚人
太妈	太妈
布妈	布妈
汗妈	汗妈
庶人	庶人
偷人	偷人
饵人	饵人
桶人	桶人
乌人	乌人
弘哥	弘哥
房仔	房仔
六妈	六妈
伤人	伤人
涌人	涌人
利姐	利姐
环哥	环哥
梨人	梨人
狱者	狱者
秉哥	秉哥
勐哥	勐哥
司人	司人
稀哥	稀哥
改哥	改哥
铭仔	铭仔
感者	感者
研妈	研妈
壮爸	壮爸
思爸	思爸
袍哥	袍哥
链人	链人
荣妈	荣妈
俭氏	俭氏
屠者	屠者
买哥	买哥
凰姐	凰姐
尧姐	尧姐
画人	画人
日哥	日哥
山爸	山爸
塘哥	塘哥
蛇哥	蛇哥
勃哥	勃哥
律者	律者
梅氏	梅氏
帽人	帽人
调人	调人
钢哥	钢哥
虫妈	虫妈
问哥	问哥
臻哥	臻哥
心爸	心爸
适人	适人
采哥	采哥
丽氏	丽氏
焰人	焰人
秒哥	秒哥
春氏	春氏
蒙氏	蒙氏
毅者	毅者
已氏	已氏
枪人	枪人
狐哥	狐哥
承哥	承哥
洋者	洋者
尤哥	尤哥
丹者	丹者
遥妈	遥妈
砂人	砂人
范人	范人
涛人	涛人
港姐	港姐
劾者	劾者
走人	走人
疯氏	疯氏
溜哥	溜哥
梅者	梅者
花妈	花妈
闾氏	闾氏
料人	料人
淫哥	淫哥
苗哥	苗哥
迪爸	迪爸
摄氏	摄氏
一氏	一氏
湘仔	湘仔
灰哥	灰哥
已者	已者
稳哥	稳哥
治氏	治氏
易爸	易爸
骨哥	骨哥
絮人	絮人
骗人	骗人
闹哥	闹哥
你姐	你姐
第人	第人
民姐	民姐
逗妈	逗妈
航爸	航爸
理氏	理氏
球妈	球妈
绵人	绵人
昂妈	昂妈
团哥	团哥
蚊哥	蚊哥
巧仔	巧仔
虽人	虽人
旦人	旦人
毋人	毋人
典哥	典哥
敦妈	敦妈
耳人	耳人
衰人	衰人
铮哥	铮哥
瑾妈	瑾妈
甫妈	甫妈
加仔	加仔
宁氏	宁氏
衡妈	衡妈
濠哥	濠哥
戈者	戈者
证人	证人
寻人	寻人
琨哥	琨哥
粗人	粗人
送人	送人
然姐	然姐
旦姐	旦姐
想哥	想哥
么者	么者
蕃哥	蕃哥
狙人	狙人
范妈	范妈
寒爸	寒爸
佩氏	佩氏
狗者	狗者
浑氏	浑氏
权妈	权妈
九仔	九仔
砂者	砂者
股人	股人
伟氏	伟氏
蓬姐	蓬姐
松爸	松爸
贝人	贝人
率哥	率哥
链者	链者
仡人	仡人
烟者	烟者
辩者	辩者
哥妈	哥妈
塞氏	塞氏
教哥	教哥
佐妈	佐妈
耶哥	耶哥
果姐	果姐
判者	判者
歪哥	歪哥
纪氏	纪氏
哀哥	哀哥
春仔	春仔
测者	测者
臭人	臭人
绎者	绎者
屁哥	屁哥
闻妈	闻妈
法哥	法哥
塞哥	塞哥
追人	追人
累人	累人
护者	护者
仔人	仔人
柜人	柜人
椒姐	椒姐
见者	见者
房哥	房哥
创哥	创哥
母哥	母哥
列氏	列氏
迪仔	迪仔
晞妈	晞妈
缚者	缚者
尘人	尘人
送哥	送哥
桂哥	桂哥
维爸	维爸
玲仔	玲仔
慢人	慢人
纬哥	纬哥
命氏	命氏
胜爸	胜爸
亚哥	亚哥
复人	复人
骐妈	骐妈
薪者	薪者
砍人	砍人
芗人	芗人
海氏	海氏
溪爸	溪爸
离者	离者
聊哥	聊哥
旺仔	旺仔
惠爸	惠爸
弓者	弓者
月爸	月爸
悦哥	悦哥
聪爸	聪爸
载者	载者
耶氏	耶氏
庭氏	庭氏
宏妈	宏妈
疆者	疆者
蓝者	蓝者
力爸	力爸
骆氏	骆氏
逆人	逆人
瑾爸	瑾爸
芳哥	芳哥
响妈	响妈
座人	座人
瑰人	瑰人
期哥	期哥
张哥	张哥
珂哥	珂哥
源爸	源爸
血哥	血哥
熙姐	熙姐
箭人	箭人
薄氏	薄氏
狐者	狐者
戴姐	戴姐
慕妈	慕妈
械人	械人
剩人	剩人
佣者	佣者
弹哥	弹哥
聊人	聊人
婕姐	婕姐
鞋者	鞋者
毕哥	毕哥
炭人	炭人
麒妈	麒妈
劳人	劳人
龟人	龟人
蒙爸	蒙爸
楫人	楫人
倍哥	倍哥
钩哥	钩哥
省人	省人
付哥	付哥
土仔	土仔
脚哥	脚哥
造者	造者
肥者	肥者
难者	难者
琰哥	琰哥
耍哥	耍哥
宫人	宫人
梦哥	梦哥
璐爸	璐爸
誉哥	誉哥
选人	选人
丽爸	丽爸
毋氏	毋氏
督哥	督哥
感人	感人
桃人	桃人
包爸	包爸
严妈	严妈
建妈	建妈
木妈	木妈
闷人	闷人
耿氏	耿氏
将哥	将哥
欢者	欢者
胡人	胡人
增哥	增哥
单姐	单姐
欺人	欺人
梭人	梭人
虚者	虚者
鹅人	鹅人
从者	从者
苍人	苍人
堡人	堡人
搁人	搁人
卓爸	卓爸
瑟氏	瑟氏
徒者	徒者
女哥	女哥
汉爸	汉爸
依哥	依哥
仁氏	仁氏
俚人	俚人
兆哥	兆哥
濡哥	濡哥
姆氏	姆氏
动哥	动哥
瓶哥	瓶哥
长氏	长氏
河氏	河氏
胧人	胧人
汤人	汤人
侬哥	侬哥
汉氏	汉氏
必人	必人
狩者	狩者
定哥	定哥
毒哥	毒哥
祝哥	祝哥
陶哥	陶哥
巴氏	巴氏
郎姐	郎姐
越哥	越哥
悉人	悉人
嫦姐	嫦姐
峡人	峡人
焕哥	焕哥
屠哥	屠哥
阏氏	阏氏
淇氏	淇氏
申哥	申哥
足者	足者
九姐	九姐
财姐	财姐
葵姐	葵姐
轮哥	轮哥
策哥	策哥
漠者	漠者
旦妈	旦妈
游妈	游妈
艳者	艳者
阁者	阁者
茂氏	茂氏
靖妈	靖妈
由者	由者
忠妈	忠妈
旷氏	旷氏
牙姐	牙姐
霜妈	霜妈
囡妈	囡妈
廷妈	廷妈
卿氏	卿氏
桐人	桐人
榆妈	榆妈
杂人	杂人
咩哥	咩哥
则氏	则氏
档人	档人
贡者	贡者
咪人	咪人
即人	即人
审人	审人
湘妈	湘妈
曰哥	曰哥
金妈	金妈
柯姐	柯姐
脉者	脉者
刁姐	刁姐
阴者	阴者
妹爸	妹爸
弄人	弄人
藤氏	藤氏
晃哥	晃哥
麓人	麓人
色姐	色姐
布者	布者
筏者	筏者
肠哥	肠哥
侠氏	侠氏
房者	房者
胥氏	胥氏
霞哥	霞哥
走者	走者
温人	温人
昱哥	昱哥
卷妈	卷妈
笠人	笠人
杏哥	杏哥
柴人	柴人
光妈	光妈
鼠人	鼠人
笙人	笙人
呀人	呀人
玉仔	玉仔
白者	白者
鹿姐	鹿姐
瘦人	瘦人
伊姐	伊姐
栗姐	栗姐
须哥	须哥
察者	察者
好者	好者
毫哥	毫哥
瘾者	瘾者
封者	封者
曾者	曾者
袋人	袋人
战人	战人
丸妈	丸妈
岳氏	岳氏
者者	者者
慌者	慌者
布爸	布爸
棒哥	棒哥
岔人	岔人
瑾姐	瑾姐
铖爸	铖爸
凯爸	凯爸
综人	综人
燕妈	燕妈
辉仔	辉仔
绪者	绪者
速哥	速哥
画妈	画妈
赞哥	赞哥
克仔	克仔
慧爸	慧爸
乙哥	乙哥
争哥	争哥
富氏	富氏
坝人	坝人
裕姐	裕姐
儒妈	儒妈
布氏	布氏
恨人	恨人
头妈	头妈
嘉爸	嘉爸
偲者	偲者
朝者	朝者
泳哥	泳哥
韬妈	韬妈
姬姐	姬姐
犯者	犯者
曾氏	曾氏
霆哥	霆哥
垌人	垌人
绪哥	绪哥
银哥	银哥
嗨哥	嗨哥
晋妈	晋妈
征哥	征哥
路爸	路爸
科爸	科爸
蛋爸	蛋爸
不妈	不妈
